Index	Name
null	null
null	null
WarrivAct1IntroGossip1	35 \n自己紹介はさせてくれないそうだ。
WarrivAct1IntroPalGossip1	35 \n自己紹介はさせてくれないそうだ。
WarrivGossip1	40 \n東の砂漠をキャラバンで渡るようにな \nって20年以上になる。山賊の襲撃も日 \n常茶飯事だが、パラディンが一緒のと \nきに襲われた事はない。 \n  \nつまり君の教団には、恩があるわけだ。 \n君が事件を解決して東への門を開いて \nくれることを祈っている。 \n
WarrivGossip2	81 \nケインはかなり魔物に詳しいらしい。 \nそんな知識を蓄えるほど長生きはした \nくないな。 \n
WarrivGossip3	54 \nアカラはローグ族の神官長だ。マジッ \nクアイテムを売っているし、傷を治す \n力もある。聡明な女性だから、力にな \nってくれるだろう。 \n
WarrivGossip4	56 \nカシャはローグ族の戦闘隊長だ。ほと \nんど話したことはないが、よそ者は好 \nかないようだな。 \n
WarrivGossip5	77 \nチャルシはいい娘だよ。鍛治屋をして \nいるから、武器や防具のことなら相談 \nするといい。 \n
WarrivGossip6	48 \nギードは何でも扱う行商人で、私のキ \nャラバンと一緒に東に向かう途中だ。 \nあまり信用はできない。 \n  \n品物は確かだが、欲が深くてな。もし \n取り引きするなら、気を許さないこと \nだ。 \n
WarrivGossip7	65 \n東にあるのは神秘の大地と、砂漠の宝 \n石、ラット・ゴーレインの街。 \n
WarrivGossip8	64 \n君が修道院の魔物を退治できたら、ロ \nーグ族も山への門を開く。その時は喜 \nんで東へ連れていこう。 \n
WarrivGossip9	57 \n聖堂へ向かう途中の荒野は迷いやすい。 \n岩の原の崖にある洞窟が地下通路にな \nっているから、そこを通った方がいい \nだろう。 \n
AkaraIntroGossip1	30 \n私はアカラ、「見えざる眼」教団の神 \n官長です。ようこそ、旅のお方。残念 \nながら粗末な宿しか提供できませんが。 \n  \n  \nご覧の通り、我らは忌まわしい呪いに \n苦しんでいます。代々、東への門を守 \nる砦でもあった我らの修道院が、女魔 \n神アンダリエルに占拠されたのです。 \n  \n  \n信じがたい事ですが、シスターの多く \nが魔神に加勢し、我らを修道院より追 \nいました。裏切らなかった者のほとん \nどは命を落とすか、荒野ではぐれまし \nた。 \n  \nお願いします。どうかお助けください。 \nこの呪いをはらってくださるなら、永 \n遠の感謝と協力を誓います。 \n
AkaraIntroSorGossip1	31 \nこんにちは、お若いソーサレスさん。 \nこの暗い時代に、あなたのような方が \nいるのは心強い事です。大いなる影に \n立ち向かうには、もっと女の力が必要 \nですわ。そうそう、申し遅れました... \n  \n  \n私はアカラ。「見えざる眼」教団の神 \n官長です。ようこそ、旅のお方。残念 \nながら粗末な宿しか提供できませんが。 \n  \n  \nご覧の通り、我らは忌まわしい呪いに \n苦しんでいます。代々、東への門を守 \nる砦でもあった我らの修道院が、女魔 \n神アンダリエルに占拠されたのです。 \n  \n  \n信じがたい事ですが、シスターの多く \nが魔神に加勢し、我らを修道院より追 \nいました。裏切らなかった者のほとん \nどは命を落とすか、荒野ではぐれまし \nた。 \n  \nお願いします。どうかお助けください。 \nこの呪いをはらってくださるなら、永 \n遠の感謝と協力を誓います。 \n
AkaraGossip1	39 \n「見えざる眼」教団は、長く輝かしい \n歴史を誇ります。いつしか我らのシス \nターは強力な武装集団となり、同時に、 \n自らの運命を自らの手で決めたいと願 \nう女性達の砦ともなりました。 \n  \nしかし、お気をつけなさい。力と知識 \nはたやすく悲劇につながります。私は、 \n強い勇気や得がたい英知を持つ人が、 \n野心や無謀によって身を滅ぼすのを何 \n度も見ました。 \n  \n暗い道を切り開くには、足下に用心す \nるのです。 \n
AkaraGossip2	39 \nケインという人は、古きホラドリムの \n生き残りで、膨大な知識を持っている \nと聞きます。危機の正体を見きわめる \n手助けをしてくれるかもしれません。 \n
AkaraGossip3	35 \nカシャは常に炎のごとき忠誠心を示し \nてくれますが、今はその怒りが裏目に \n出はしないかと心配です。自分の下に \n残った仲間をとても大切にしていて、 \nよほどの事がないと闘わせようとはし \nません。 \n
AkaraGossip4	35 \nチャルシは若く無垢な娘です。しかし \nバーバリアンの血のためか、冒険に惹 \nかれるようですね。鍛冶の仕事を通し \nて悪に立ち向かう手助けをする事を、 \n誇りにしています。 \n
AkaraGossip5	40 \nワリヴとはあまり親しくありませんが、 \nかなりの苦労を重ねてきた人のようで \nすね。しかし地を覆う魔軍の恐ろしさ \nを知りながら、自分のキャラバンを東 \nに向かわせる事しか考えていないよう \nに見受けられます。 \n
AkaraGossip6	40 \n正直なところ、あまりギードには関わ \nりたくありません。常に嘘をまとい、 \n成功のためには他人の不幸につけ込む \nような人です。 \n
AkaraGossip7	46 \n荒野も、そして我らの家たる修道院も、 \n魔神の軍勢に占領されております。彼 \nらを打ち払い、世界に秩序を取り戻さ \nねばなりません。 \n
AkaraGossip8	39 \n教団が再興する夢をよく見ます。「見 \nえざる眼」は未来の栄光を予見してい \nますが、その時期まではわかりません。 \n \n
AkaraGossip9	57 \n我々の誇りは心の鍛錬と弓矢の技です... \nそれでこの難局を乗り切れればよいの \nですが。 \n
AkaraGossip10	50 \n裏切ったローグの二の舞とならぬよう。 \n命を失うのも悲劇ですが、魂を失うの \nはそれ以上の悪夢です。 \n
AkaraGossip11	36 \nかつてのシスターとはいえ、裏切った \n者達に慈悲は無用です。今はアンダリ \nエルの配下なのですから。 \n  \n女魔神を倒せばシスターらが正気に戻 \nる可能性も、あるかもしれません。し \nかし、呪われた契約は永遠かもしれな \nいのです。 \n
KashyaIntroGossip1	46 \nあばら屋へようこそ。私たちを修道院 \nから追い払った魔物を退治に来たんだ \nね。 \n  \nでも覚えておいて。ローグ族の信仰を \n導くのはアカラでも、戦闘を指揮する \nのは私だよ。ちょっとザコを倒したぐ \nらいじゃ、信用しないからね。 \n
KashyaIntroAmaGossip1	46 \nへえ。ここでアマゾンに会うとは思わ \nなかったわ。こんな所に来るなんて勇 \n敢ねえ。でも、勇敢だった仲間のシス \nターも敵の魔法に倒されたのよ。あん \nたも気をつけてね。 \n
KashyaGossip1	48 \n子供の頃、アカラがよく話してくれた \nわ。アマゾンの戦士は勇気があって、 \nスピアと弓矢が得意だって。私たちロ \nーグ族とあんた達は、似てるわね。 \n
KashyaGossip2	53 \nデッカード・ケインって男の噂は、部 \n下から聞いてるわ。すごい知恵がある \nんだってね。でも戦い方も知らないよ \nうな奴が、そう利口とも思えないけど。 \n \n
KashyaGossip3	48 \nアカラはずっと私の母親代わりよ。賢 \nくていい人なんだけど、修道院を武力 \nで取り戻すような強さはないかもね。 \n
KashyaGossip4	89 \nよそ者は好きじゃないけど、ワリヴは \nまだ信用できそうだね。 \n
KashyaGossip5	59 \nチャルシは鍛治屋で、武器や防具を扱 \nうんだ。かなりの腕だよ。 \n  \nただし、今はロクな道具がないから間 \nに合わせの仕事しかできないけど。 \n
KashyaGossip6	40 \nギードはブタだね。何度も放り出して \nやろうと思ったけど、チャルシと気が \n合うみたいだからガマンしてるんだ。 \n
KashyaGossip7	64 \nアンダリエルが教団のシスターを寝返 \nらせた方法さえわかれば、みんなを正 \n気に戻す事もできるかもしれない。 \n
KashyaGossip8	64 \n今、教義を守る者は、商人や家畜に囲 \nまれて仮住まいさ。 \n  \n難民キャンプへようこそ。 \n
KashyaGossip9	67 \nトリストラムの街は自業自得かもよ。 \n魔神を地上に放したそうじゃないの。 \n
KashyaGossip10	62 \n夜には時々、火を囲んで昔話をするん \nだ...修道院を占領された時のことを忘 \nれたくてね。 \n
CharsiIntroGossip1	40 \nこんちは、あたしチャルシ。ここの鍛 \n治屋よ。冒険者の人に会えて嬉しいわ。 \n \n  \nトリストラムがディアブロに襲われた \n時は、教団の戦士がたくさん援軍に出 \nて、強力なアイテムをいっぱい持って \n帰ったわ。でもすぐに反撃されて、し \nかもその人達の大部分がアンダリエル \nに寝返っちゃったんだけど。 \n
CharsiIntroBarGossip1	50 \nわあ、あんたバーバリアン？　ステキ \nだわ。冒険の旅ができるなんて、うら \nやましい。私も行けたらなあ。 \n  \nそうそう、あたしはチャルシ。ここの \n鍛治屋よ。 \n
CharsiGossip1	47 \n小さいときからずっと教団にいるんだ \nけど、あたしの本当の親は北の方のバ \nーバリアンで、あたしが赤んぼの時に \n殺されたんだって。アカラから聞いた \nわ。 \n  \n時々、バーバリアンとして育ってたら \nどんなだったかなって思うわ。 \n  \nもちろん鍛治屋の仕事は好きだけど、 \n冒険とか探検にも行ってみたくてさあ。 \n \n
CharsiGossip2	78 \nケインのことはよく知らない。なんか \n秘密が多いみたいで。 \n
CharsiGossip3	44 \nカシャはステキな人よ。よそ者には厳 \nしいけど、それも教団を守るためなの。 \nでも、仲間のシスターに裏切られたか \nら、それで余計に厳しくなるんだと思 \nう。 \n
CharsiGossip4	60 \nシスター達の裏切りに一番怒ったのは、 \nアカラね。神官長として責任を感じた \nみたいだし。 \n
CharsiGossip5	80 \nワリヴはいい人みたいよ。ちょっとマ \nジメすぎるけど。 \n
CharsiGossip6	54 \nギードと話すと面白いよ。いろんな場 \n所の話を聞かせてくれるの。自分でも \n見てみたいな。 \n
CharsiGossip7	84 \nシスター達がどうしてアンダリエルに \n寝返ったのか、わかんない。みんな立 \n派な戦士だったのに。 \n
GheedIntroGossip1	48 \nやあ相棒、いらっしゃい！　俺ぁギー \nドだ。あんたとは気が合いそうだね！ \n \n  \n要るモノがあったら、何でも用意する \nぜ。替えの武器とか、金のカケラとか、 \nちっこい宝石とか、そんなのと交換 \nだ。 \n  \nさあさあ、何かないかい？　ウチの商 \n品は一生もんだし、２日間の保証つき \nだよ！ \n
GheedIntroNecGossip1	44 \nネクロマンサー！　二度と会いたくな \nかった手合いだね。騒動のせいで、い \nろんな奴が来やがる。でもあんた、カ \nネはありそうだな...。 \n  \n要るモノがあったら、何でも用意する \nぜ。替えの武器とか、金のカケラとか、 \nちっこい宝石とか、そんなのと交換だ \nだ。 \n  \nさあさあ、何かないかい？　ウチの商 \n品は一生もんだし、２日間の保証つき \nだよ！ \n
GheedGossip1	62 \nとぼけるんじゃないぜ、あんたらネク \nロマンサーの術はこの目で見たんだ。 \n外の魔物とグルだとしても、知りたか \nないね。とっとと取り引きして消えて \nくれ！ \n
GheedGossip2	51 \nケインってジイさんは頭がおかしいよ。 \nトリストラムの生き残りだそうだけど、 \n話はまるで信用できないね。 \n
GheedGossip3	41 \nアカラとカシャは「見えざる眼」教団 \nの有力者だけど、両極端だね。アカラ \nは魔力の河で、カシャは燃える火だ。 \nどっちも教団への忠誠は絶対で、シス \nター達の裏切りを悲しんでるけどね。 \n
GheedGossip4	40 \nチャルシはいい子なんだが...商才がな \nいぜ！　武器や防具をあんな値で売っ \nちゃ、儲けが出ないだろうに。 \n  \n俺の冒険の話にばっかり夢中で、その \n冒険で稼いだカネにゃ興味ないしさ。 \n
GheedGossip5	48 \nワリヴはまあ、キャラバンに同行させ \nてくれるぐらいは親切なんだが、抜け \n目ない男だ。 \n  \n俺ぁここで、ローグ族をカモにしよう \nと狙ってんのさ。でも、あんたにゃ負 \nけとくよ！ \n
GheedGossip6	52 \nアンダリエルの軍勢は、修道院だけじ \nゃなく森の家も占領したぜ。俺ぁ外に \nゃ出たかないね。用があったらここに \n来てくれ。 \n
GheedGossip7	62 \nもしラット・ゴーレインに着けたら、 \nナーラント草の煙をたんまり吸って、 \nみっちりトリップしたいなあ。 \n
CainGossip1	39 \n遠い昔、大天使ティラエルがホラドリ \nムにソウルストーンを授けた。３人の \n魔王を封印するためにな。だがその聖 \nなる遺物も、ディアブロの力には屈し \nたというわけだ。 \n  \n残る２人の魔王は、もっとしっかり封 \n印されておればよいが...。 \n
CainGossip2	54 \nスキルの修得には時間がかかる。実戦 \nが最高の鍛錬だ。スキルを選ぶ際には \nよく考えるのだぞ。 \n
CainGossip3	52 \n倒した魔物が、見なれぬ品を持ってい \nる事もあろう。役に立つ品も多いが、 \n危険もあるぞ！　鑑定してやるから、 \nまずわしに見せよ。 \n
CainGossip4	36 \nホラドリムの話はしたかな？　これは \n太古、いくつもの魔道師族が魔王たち \nを封印するために結成した盟約組織な \nのだ。だが今では、その存在は半ば忘 \nれ去られ、封印さえも解けつつある！ \n \n  \nホラドリムの生き残りとして頼む。君 \nの力を貸してくれ。 \n
CainGossip5	32 \n遙かな昔、多くの魔神が結託して三魔 \n王を地獄より追放したのだが...アンダ \nリエルがディアブロと通じておるとは、 \n時勢が変わったのだな。これは不吉な \n兆候だ。 \n
RogueSignpostGossip1	90 \n 戻れ！　この先に踏み入るには、もっ \nと経験が必要だ！ \n
RogueSignpostGossip2	67 \n止まれ！　まず、アカラに頼まれたク \nエストを終えるんだ。目指すべき洞窟 \nは、もっとキャンプの近くだ。 \n
RogueSignpostGossip3	116 \n覚悟しな、この先の魔物は強いよ。 \n
RogueSignpostGossip4	92 \n覚悟しな、命を落とすかもよ！ \n
RogueSignpostGossip5	88 \n気をつけな！　裏切ったローグ兵は、 \nみんな手強いよ！ \n
A1Q1InitAkara	37 \nカシャの部下達が、恐ろしい報告をも \nたらしました。この近くの洞窟に、呪 \nわしい魔物がはびこっているというの \nです。 \n  \n敵が、このキャンプを襲うために集結 \nしているのかもしれません。どうか敵 \nの巣窟を見つけ出し、叩いて頂きたい \nと思います。 \n  \n大いなる眼が見守りますように。 \n
A1Q1AfterInitAkara	37 \nかの地で、多くの偵察兵が命を落とし \nました。この上損失は出せません。邪 \n悪の巣窟へは、あなただけでお願いし \nます。 \n
A1Q1AfterInitKashya	87 \nあの洞窟の魔物には、腕利きの弓兵が \n何人もやられた。あんたの手に負える \nかな？ \n
A1Q1AfterInitCharsiMain	95 \n魔物は洞窟を拠点にして村を荒らして \nるのよ。外を歩くなら気をつけてね。 \n
A1Q1AfterInitCharsiAlt	81 \n立派な戦士みたいね。頑張ってね。 \n
A1Q1AfterInitGheed	62 \nあんたぁ勇敢だねぇ！　あの穴に入る \nなんて、病気持ちの商売女に突っ込む \nよりおっかないぜ！ \n
A1Q1AfterInitWarriv	134 \nあの洞穴を探る者は死に出会う。 \n
A1Q1EarlyReturnAkara	85 \n洞窟の魔物を残らず倒すまで、あなた \nの務めは終わりません。 \n
A1Q1EarlyReturnKashya	108 \n信用されたいなら、しっかりやりな。 \n
A1Q1EarlyReturnCharsi	148 \nまだ洞窟は終わらない？　何かいるの？ \n \n
A1Q1EarlyReturnGheed	73 \nまだ穴掃除は終わんないんだろ？　も \nっといい武器を買わないか？ \n
A1Q1EarlyReturnWarriv	120 \nためらう心に道理あり。 \n
A1Q1SuccessfulAkara	65 \n邪悪の巣窟を滅ぼしたのですね。やっ \nと信頼できる人を見つけることができ \nました。 \n  \nお礼に、お望みのスキルを授けましょ \nう。 \n
A1Q1SuccessfulKashya	62 \nあんたが生き残るとは思わなかったな。 \nアカラに会えば、ほうびがもらえるよ。 \n  \n
A1Q1SuccessfulCharsi	94 \n本当に勇敢で強いのね。アカラが心配 \nしてたのに。 \n
A1Q1SuccessfulGheed	78 \nいい魔物は死んだ魔物だけさ。 \n  \nところで洞窟で、何か売れそうな物は \n見つけたかい？ \n
A1Q1SuccessfulWarriv	117 \n生ある限り、全てが試練だ。 \n
A1Q2InitKashya	42 \n偵察隊から恐ろしい報告を聞いた。修 \n道院の墓地が荒らされてるんだ！ \n  \nアンダリエルは命を奪うだけじゃ足り \nないらしい。ウチの士官で、トリスト \nラムの街でディアブロと闘ったブラッ \nド・レイヴンも、死から蘇って敵にな \nった。 \n  \n彼女は修道院の墓地を掘り返して、仲 \n間の死体をゾンビに変えてる。 \n  \nそんな冒涜は許せない。頼むからブラ \nッド・レイヴンを倒してくれ！ \n
A1Q2AfterInitKashya	75 \nブラッド・レイヴンは生前も勇敢だっ \nたけど、死んでますます強くなったよ \nうだよ。 \n
A1Q2AfterInitCharsi	99 \nブラッド・レイヴンは、トリストラム \nでディアブロと闘った部隊の隊長だっ \nたのよ。 \n
A1Q2AfterInitGheed	94 \n生き返った死体の話はしたくない。返 \n品お断りの主義に反するんでね。 \n
A1Q2AfterInitAkara	43 \nブラッド・レイヴンはトリストラムの \nカタコンベで勇敢に戦いましたが、そ \nの後変わってしまいました。魔神の影 \n響を伝染させたのも彼女のようです。 \n
A1Q2AfterInitWarriv	140 \nふうむ... \n  \n死者をどうして殺せようか？ \n
A1Q2EarlyReturnKashya	99 \nグズグズしてる間に、ブラッド・レイ \nヴンのゾンビ軍はどんどん増えるよ！ \n
A1Q2EarlyReturnAkara	65 \nブラッド・レイヴンを倒せなければ、 \n教団はおしまいです。 \n
A1Q2EarlyReturnCharsi	65 \n直接の攻撃を受ける前から、アカラは \n異変を感じてたみたい。ブラッド・レ \nイヴンがトリストラムの地下で敵の魔 \n力を受けていたのね。 \n  \nそのとき動いておけば... \n
A1Q2EarlyReturnGheed	73 \nメルラって女もゾンビになったのかな？ \nあいつにゃ色々と噂があるんだが。 \n  \n
A1Q2EarlyReturnWarriv	83 \n死者が蘇り生者を襲う、その恐怖は想 \n像を絶する。 \n
A1Q2SuccessfulKashya	45 \nホントにブラッド・レイヴンを倒せた \nんだね！ \n  \n元は私の親友だったけど、これで安ら \nかに眠れるよう祈るよ。 \n  \n今後はあんたを信用するわ。協力も惜 \nしまない。部下の精鋭をつけてあげる。 \n  \n
A1Q2SuccessfulAkara	122 \nアンダリエルに、この報いを受けさせ \nなければ！ \n
A1Q2SuccessfulCharsi	73 \nカシャがブラッド・レイヴンを倒して \nくれたお礼をしたいって。あたしも感 \n謝するわ。元は仲間だった人だけどね。 \n  \n
A1Q2SuccessfulGheed	148 \nここの娘は最初のうちは素っ気ないん \nだ。 \n
A1Q2SuccessfulWarriv	104 \n見事なものだな。その努力が報われる \nことを祈る。 \n
A1Q4InitAkara	42 \nただ武力のみで魔神と戦っても、勝利 \nは望めません。 \n  \n古代の英知を究めたホラドリムの賢者 \nが、今もただ一人だけ残っています。 \n名はデッカード・ケイン。 \n  \nトリストラムに旅して彼を捜すのです。 \n  \n
A1Q4AfterInitScrollKashya	90 \nイニファスの樹皮に秘密のルーン文字 \nが隠されてる。 \n  \nアカラが翻訳してくれるよ。 \n
A1Q4AfterInitScrollAkara	36 \nトリストラムは遠く、歩いて着く頃に \nはケインの命がありません。一瞬でか \nの地に行ける魔法の門をお使いなさい。 \n  \n  \nケルンの輪の中に立ち、一定の順序で \n石に触れれば、その門が働きます。順 \n序は、イニファスの樹の皮にルーン文 \n字で書かれています。 \n  \n聖なるイニファスの樹を見つけ、皮を \n持ち帰るのです。私が翻訳してあげま \nしょう。 \n
A1Q4AfterInitScrollCharsi	114 \nアカラにイニファスの皮を渡せば、ト \nリストラムに行けるよ。 \n
A1Q4AfterInitScrollWarriv	54 \n何人かトリストラムの生き残りに会っ \nたが、ケインは半ば狂って夢と現実の \n区別がつかなくなっていると聞いた。 \n
A1Q4AfterInitScrollGheed	98 \nトリストラムなんかに行くよりゃ、ビ \nールに小便混ぜて飲む方がマシだね！ \n
A1Q4InstructionsCharsi	150 \nイニファスの樹皮がないとケインに会 \nえないよ。 \n
A1Q4EarlyReturnSAkara	71 \nケインに会いたくはないのですか？　 \nイニファスの樹を探すことが旅の第一 \n歩です。 \n
A1Q4EarlyReturnSKashya	96 \nイニファスの樹は見つけにくいけど、 \n一目見ればわかるわ。 \n
A1Q4EarlyReturnSGheed	99 \n他の樹の皮をはいだのかい？　よく見 \nなよ。 \n
A1Q4EarlyReturnSWarriv	66 \n求める物を見失ったなら、己の心のう \nちを見よ...あるいは、さらに探せ。 \n
A1Q4SuccessfulScrollKashya	71 \nこれがあれば、トリストラムへの道が \n開けるね。アカラに読んでもらいなよ。 \n \n
A1Q4SuccessfulScrollCharsi	168 \nこれは、アカラの所へ持ってって。 \n  \n読めるのはあの人だけよ。 \n
A1Q4SuccessfulScrollGheed	72 \nおいおい、俺ぁたいがい変な品も扱う \nが、木の皮は買わねえ。 \n
A1Q4SuccessfulScrollWarriv	85 \nこれは私には読めない。アカラに頼む \nんだ。 \n
A1Q4InstructionsAkara	54 \nお見事です。説明を書き留めておきま \nした。ケルンの輪を見つけ、この通り \nの手順で石に触れなさい。 \n
A1Q4EarlyReturnKashya	93 \nケインは敵の手がかりをよく知ってる \nんだ。頼むよ！ \n
A1Q4EarlyReturnCharsi	86 \nトリストラムは全滅したけど、ケイン \nに会えなきゃあたしらも全滅ね。 \n
A1Q4EarlyReturnGheed	63 \nトリストラムは今、宴会場みたいだっ \nて聞くぜ...バーバリアンが騒いだ後の！ \n無事の帰りを待ってるよ。 \n
A1Q4EarlyReturnWarriv	74 \n危険すぎる旅だ。私は同行できない。 \n
A1Q4EarlyReturnAkara	54 \n生きているとしても、ケインの命は風 \n前の灯でしょう。どうか急いでくださ \nい。 \n
A1Q4QuestSuccessfulAkara	82 \nありがとう、ケインを救ってくれたの \nですね。 \n  \n彼の話をよくお聞きなさい。 \n
A1Q4QuestSuccessfulKashya	67 \nまったく大したもんだね。 \n  \nケインを連れてきてくれて、本当にあ \nりがとう。アカラに会っておくといい \nよ。 \n
A1Q4QuestSuccessfulGheed	48 \nケインが来た...新しい客だ！　こんな \nに幸せな気分は、美人の生娘に言い寄 \nられた時以来だよ。 \n
A1Q4QuestSuccessfulCharsi	102 \nアカラがあんたにお礼したいそうよ。 \n
A1Q4QuestSuccessfulWarriv	75 \nケインを救出できたとは、素晴らしい \n勇気だ。急いでアカラに会うといい。 \n
A1Q4QuestSuccessfulCain	74 \n感謝のしるしに、いつでもアイテムを \n鑑定してやろう。金などいらんよ。 \n
A1Q4RescuedByHeroCain	82 \nありがとう、これで助かった。 \n
A1Q4RescuedByRoguesCain	75 \nローグ族に栄えあれ！　ようやく呪わ \nれた地から抜け出せた！ \n
A1Q4TragedyOfTristramCain	26 \n残念ながらトリストラムの悲劇を防ぐ \nことはできず、最も恐れていた事態が \n起こってしまった。恐怖の王ディアブ \nロが、再び地上に解き放たれたのだ！ \n \n  \n知っての通り、ディアブロは先日トリ \nストラムの地下で倒された。勇者の勝 \n利を知った我々は、街中を挙げて何日 \nも祝宴を開いた。 \n  \nだがそのうち、勇者は人を遠ざけ、暗 \nい部屋でふさぎ込むことが多くなった。 \nわしはてっきり、悪夢のような戦いの \n記憶に苦しんでいるのだろうと思った。 \n  \n  \n彼の具合は次第に悪くなり、夜中にう \nなされるようになった。「東」とか何 \nとか叫んで、飛び起きる事もあった。 \n  \n  \nある日勇者は消え、そのすぐ後、街は \n魔物の軍に襲われた。住民のほとんど \nは殺され、わしは牢に投げ込まれた。 \n飢え死にさせる気だったのだ。 \n  \n修道院が陥落する前に現れた黒衣の放 \n浪者というのは、トリストラムの勇者 \nのなれの果てだろう。 \n  \nあまり考えたくはないが...ディアブロ \nが、勇者の体を奪って蘇ったのかもし \nれん。だとすれば奴は、今までになく \n強大だぞ！ \n  \n奴を倒さねば、この世は終わりだ。 \n
A1Q5InitQuestTome	28 \nかつて、ある伯爵夫人は人の生き血を \n若返りの妙薬と信じ、百人もの乙女を \n殺してその血を浴びた。だが悪事は露 \n見して彼女は生き埋めにされ、その居 \n城だった塔はたちまち廃墟と化した。 \n神に見放された荒野にそびえるその姿 \nは、あたかも邪悪の記念碑のごとくで \nあった。 \n  \n伯爵夫人の財産は聖職者に没収され分 \n配されたが、まだ塔に隠された財宝が \n残っているとも噂されている。人類の \n悪の極みを目撃した犠牲者の遺骨とと \nもに、静かに埋もれていると...。 \n
A1Q5AfterInitGheed	110 \nあの塔に残ってるモノなんざ、ネズミ \nのフンぐらいさ。 \n
A1Q5AfterInitCharsi	61 \nあの塔は相当ひどく傷んでるらしいわ。 \n教団のシスターが探検に入って、頭の \n上の階段が崩れて死んだ事もあるんで \nすって。 \n
A1Q5AfterInitAkara	56 \n危険なのは建物のもろさだけではあり \nません。毒ガスに倒れた者も多くおり \nました。 \n
A1Q5AfterInitCain	49 \nかの塔は叙事詩にも詠われたほどの難 \n所だ。恐ろしい悲惨に耐えねばならぬ。 \n \n
A1Q5AfterInitWarriv	70 \n埋もれた財宝の噂は、どこにでもある。 \n惑わされて命を落とす者も、どこにで \nもいる。 \n
A1Q5AfterInitKashya	75 \n歴史書には財宝の記録が残ってるんだ \nけど、あたしらが見つけたのは廃墟と \n骸骨だけさ。 \n
A1Q5EarlyReturnKashya	151 \n宝探しはあきらめたのかい？ \n
A1Q5EarlyReturnCain	94 \n素早く入り素早く出よ。言えるのはそれ \nれだけだ。 \n
A1Q5EarlyReturnWarriv	118 \n満ちた墓より空の財布の方がよい。 \n
A1Q5EarlyReturnCharsi	160 \nまだやめる気はないでしょ？ \n
A1Q5EarlyReturnAkara	140 \nあの塔について知ることは残らず話し \nました。 \n
A1Q5EarlyReturnGheed	76 \n尻のオデキにあんたの名前をつけたん \nだ。座るたんびに俺を苦しめるからよ！ \n \n
A1Q5SuccessfulKashya	60 \n当然だけど、宝は取っときな。どうせ \nあたしらじゃ見つけられなかったんだ \nし。 \n
A1Q5SuccessfulWarriv	50 \n富は雲のように移ろいやすい。ギード \nは無視することだ。弱い犬ほどよく吠 \nえる。 \n
A1Q5SuccessfulGheed	64 \nワリヴの言葉は屁と同じさ。しばらく \n空気を汚してすぐ消える。 \n
A1Q5SuccessfulAkara	49 \n塔の財宝など根も葉もない噂だと思っ \nておりましたが、成果を挙げられて何 \nよりです。その幸運に我らもあやかり \nたいものですね。 \n
A1Q5SuccessfulCharsi	126 \nそのお宝で、これからの旅が楽になる \nよ。 \n
A1Q5SuccessfulCain	66 \nよくやった。君は、勇気と強運の両方 \nに恵まれておるな。 \n
A1Q3InitCharsi	55 \n実は修道院から逃げるとき、魔法の鍛 \n冶用ハンマー、ホラドリック・マリュ \nスを置いて来ちゃったの。持ってきて \nくれたら、あんたの武器か防具に魔力 \nを吹き込んであげられるわ。 \n
A1Q3AfterInitCain	45 \nそれは、罪悪戦争の時代にホラドリム \nの魔道師が鍛えて術を施したハンマー \nだな。ホラドリムの組織が解体された \nとき、東への道を守るこの教団に託さ \nれたものだ。 \n
A1Q3AfterInitAkara	50 \nホラドリック・マリュスは修道院にあ \nりますが、あの建物はいまや地獄の魔 \n獣に埋め尽くされております。お気を \nつけて。 \n
A1Q3AfterInitKashya	60 \nチャルシほどの鍛治屋が普通のハンマ \nーを使うなんてもったいないよ。ホラ \nドリック・マリュスがあれば、立派な \n武器や防具を作ってくれるはずさ。 \n
A1Q3AfterInitCharsi	87 \n修道院の構造は複雑で、あたし達でも \n迷うほどよ。気をつけて。 \n
A1Q3AfterInitGheed	72 \nチャルシは最近、そのハンマーの話し \nかしねえんだ。まったくサミシイよ。 \n \n  \nとっとと持ってきてくれ。 \n
A1Q3AfterInitGheedAlt	81 \n魔法の肉棒なら、俺のを貸してやるの \nにな。 \n
A1Q3AfterInitWarriv	62 \n射手に弓と矢、画工に紙とペンが欠か \nせないように、チャルシの仕事にホラ \nドリック・マリュスは欠かせない。 \n
A1Q3EarlyReturnCain	52 \nなかなか見つからんようだな。兵舎の \n方をよく探すのだ。教団の鍛冶場はそ \nこにあったそうだぞ。 \n
A1Q3EarlyReturnAkara	98 \nこのクエストを終えなければ、この先 \nの敵と戦うのは難しくなります。 \n
A1Q3EarlyReturnKashya	58 \nアンダリエルと戦うには、腕と度胸だ \nけじゃだめだよ。魔法で強化された武 \n器と防具がないと。 \n
A1Q3EarlyReturnCharsi	89 \nあのハンマーはホントに凄いのよ。お \n願いだから頑張って。 \n
A1Q3EarlyReturnGheed	81 \nまだ見つからねえって？ \n
A1Q3EarlyReturnWarriv	120 \n勇気を示すいい機会だろう。 \n
A1Q3SuccessfulCain	55 \nマリュスの魔法の効果は正確には予測 \nできんが、いい結果が出るのは間違い \nない。 \n
A1Q3SuccessfulAkara	47 \nおさすがですね。しかしこれは、修道 \n院を奪還するための一歩に過ぎないこ \nとをお忘れなく。 \n
A1Q3SuccessfulKashya	57 \nホラドリック・マリュスさえあれば、 \n魔物どもに一矢報いてやれそうだよ！ \n
A1Q3SuccessfulCharsi	70 \nありがとう、マリュスを取り返してく \nれたのね！　さっそくあんたのアイテ \nムをひとつ、強化してあげる！ \n
A1Q3SuccessfulGheed	120 \n見直したぜ、あんた。スゲエよ。 \n
A1Q3SuccessfulWarriv	118 \nハンマーも君も、無事に戻って何より \nだ。 \n
A1Q6InitCain	30 \nローグのシスター達を汚染し修道院を \n奪ったのは、まず女魔神アンダリエル \nに間違いなさそうだが、そうなると先 \n行きが不安だな。 \n  \nホラドリムの古文書によれば、アンダ \nリエルは他の魔神と結託して、ディア \nブロ、メフィスト、バールの三魔王を \n地獄より追放したという。地上に出た \n魔王どもは、ソウルストーンに封印さ \nれるまで恐ろしい災厄をもたらし続け \nたという。 \n  \nそのアンダリエルがここにいるなら、 \n地獄の軍勢が再びディアブロたちの配 \n下に入ったのかもしれん。もしそうな \nら大変な脅威だ。 \n  \n修道院が永久に魔神の砦となる前に、 \nアンダリエルを討ち取らねばなるまい。 \n  \n
A1Q6AfterInitCain	37 \nディアブロは何か恐ろしい目的のため \n東に向かった。アンダリエルに修道院 \nを守らせているのは、追っ手をくい止 \nめるためだろう。 \n  \nアンダリエルは魔王ディアブロの歓心 \nを買い、高い階級を授かろうという魂 \n胆だろうな。 \n
A1Q6AfterInitAkara	55 \nアンダリエルは、我々が大切に守って \nきたものを無惨に滅ぼしました。 \n  \n今度はあなたが、あの女魔神を滅ぼし \nてください！ \n
A1Q6AfterInitCharsi	131 \nアンダリエルを地獄に送り返してね！ \n
A1Q6AfterInitGheed	68 \nアンダリエルと戦う？ \n  \n俺ぁ、今から荷車の車輪を修理するよ。 \n用があったら車の下に声をかけてくれ。 \n \n
A1Q6AfterInitWarriv	60 \n地図の上では、２点を結ぶ最短距離は \n直線だが... \n  \n東に向かう道は、どう曲げようともあ \nの修道院を避けられない。 \n
A1Q6AfterInitKashya	69 \n千回でも殺したい相手なのに、一度し \nか倒せないのは残念だわ。 \n
A1Q6EarlyReturnCain	38 \nアンダリエルが、東に向かったディア \nブロの背後を守っているのは明らかだ。 \n彼女を倒して魔王を追わねばならん。 \n  \n  \n古文書によれば、アンダリエルは焦熱 \n地獄に生まれたため炎を好まぬという。 \n  \n
A1Q6EarlyReturnAkara	50 \n努力には感謝しますが、これでは敵の \n怒りに油を注いだだけです。我々が全 \n滅するまで、攻撃は続くでしょう。 \n  \nどうか、一刻も早くアンダリエルをお \n討ちください。 \n
A1Q6EarlyReturnGheed	55 \n女魔神って、ずいぶんなベッピンなん \nだって？　「苦痛の乙女達」が言って \nたぜ。 \n
A1Q6EarlyReturnCharsi	108 \nいよいよ、勇者の力を見せる時ね。 \n
A1Q6EarlyReturnWarriv	80 \n門が開いた後、東に行けるのは我々の \nキャラバンだけだということをお忘れ \nなく。 \n
A1Q6EarlyReturn2Kashya	126 \nケインが、敵について大事な話がある \nって。 \n
A1Q6SuccessfulAkara	59 \nこれ以上の喜びはありません！ \n  \nあなたへの恩義ははかり知れません。 \n残る課題は教団の再建だけです。 \n  \n心からお礼を申し上げます。 \n
A1Q6SuccessfulCharsi	86 \nもう、東へ行っちゃうんだ...。よかっ \nたね。いるものがあったら、またいつ \nでも来てね。 \n
A1Q6SuccessfulKashya	40 \nアンダリエルが死んで、みんな生き返 \nったみたいだよ。仲間を失った哀しみ \nは消えないけど、残った者は前に進め \nるもの。 \n  \nあんたを誤解してた。あんたは本物の \n勇者だわ。その勇気は、教団がこの先 \nずっと語り継いでいくからね。 \n  \nさよなら、気をつけて。 \n
A1Q6SuccessfulGheed	100 \nさあ、大宴会だ！ \n
A1Q6SuccessfulWarriv	82 \n出発の準備はできた。いつでもラット・ \nゴーレインに向かえる。 \n
A1Q6SuccessfulCain	30 \nこれは偉大な勝利だが、まだ道のりは \n険しいぞ。わしも一緒に行って力を貸 \nそう。忘れるな、ディアブロはまだ生 \nきていて、砂漠で何かを探しておる。 \n奴の狙いを突き止めぬ限り、気は抜け \nんのだ。 \n
PalaceGuardGossip1	600 \n止まれ。 \n
PalaceGuardGossip2	290 \n通す事はできん。 \n
PalaceGuardGossip3	255 \n宮殿へようこそ。 \n
PalaceGuardGossip4	255 \n通ってもいいぞ。 \n
PalaceGuardGossip5	290 \n近寄るんじゃない。 \n
GriezIntroGossip1	50 \n今、この砂漠でどうして街が無事なの \nか、不思議に思ってるだろ。街の守備 \n兵は何もしてないぜ。あいつら、どう \nいうわけか宮殿にこもって出てこねえ \nからな。 \n  \n俺達傭兵部隊が、ジェリンに雇われて \n街を守ってんのさ。値段は安かぁない \nが、ここらの荒野で俺達の右に出る奴 \nぁいねえ。 \n
GriezGossip1	82 \n俺たちが守るのは街の中だけだ。門の \n外は魔物の縄張りだぜ。 \n
GriezGossip2	40 \n騒動が始まった途端、守備兵はみんな \n宮殿に引っ込んじまった。理由は知ら \nねえよ。街中の商売女も残らず宮殿の \n地下室に避難したから、体張って女ど \nもを「守って」やってんだろ。 \n
GriezGossip3	73 \nウチのを何人かつけてやってもいいぜ。 \nカネさえありゃ、全軍でもな。 \n
GriezGossip4	61 \nジェリンはこの交易都市の新しい領主 \nだ。歳は若いが、仕事の方はなかなか \nのもんだね。あの宮殿見りゃわかるだ \nろ。 \n
GriezGossip5	95 \nで、こうして俺らが街を守ってるんだ \nが、ジェリンの奴ぁまだ何か隠してそ \nうだな。 \n
GriezGossip6	40 \nエルジックスは大した野郎だぜ。若い \n頃は、あいつの手下と何度もやりあっ \nたが、今じゃすっかり宿屋のオヤジだ。 \n「デザート・レイン亭」が今の生き甲 \n斐だとよ。 \n
GriezGossip7	40 \nアトマはいい女なんだが、家族を亡く \nしてからふさぎ込んでてなあ。今晩非 \n番になったら、慰めに行ってやるか... \n
GriezGossip8	72 \nゲグラッシュはいい戦士なんだが、押 \nすばっかりで退くことを知らねえ。敵 \nに突っ込んで戦死するのが夢らしいや。 \n \n
GriezGossip9	63 \nメシフは南洋を駆けめぐってきた海の \n男だ。こんなとこにずっと停泊してた \nら、たまんねえだろうな。 \n
GriezGossip10	70 \nファラとはあんまり、馴染みがねえな \nあ。たいがい１人でいるしな。俺達み \nたいな傭兵は、好かねえようだな。 \n
GriezGossip11	73 \nライサンダーにゃ近づかねえ方が身の \nためだ。いつも変な薬を混ぜ合わせて \nる、変なジジイさ。そのうち自分の体 \nを吹っ飛ばすぜ！ \n
GriezGossip12	85 \nドログナンは不思議な奴だよ。どのみ \nち魔道師は信用ならねえが。 \n
ElzixIntroGossip1	55 \nあんた...腕が立ちそうだな。 \n  \n俺も昔ぁ、結構鳴らしたもんだよ。荒 \nくれ山賊を引き連れて、この辺一帯を \n震え上がらせてな。 \n  \nもっとも今じゃ宿屋の亭主で、モメ事 \nにゃ縁がねえ。 \n  \n俺の冒険は終わったわけさ。 \n
ElzixIntroNecGossip1	40 \nあんた、魔物退治に来た勇者様だな。 \nちょっと前なら、あんたみたいなのを \n見たら驚いただろうが、最近は珍しく \nもねえ。 \n  \n俺も昔ぁ、結構鳴らしたもんだよ。荒 \nくれ山賊を引き連れて、この辺一帯を \n震え上がらせてな。 \n  \n今じゃ宿屋の亭主で、モメ事にゃ縁が \nねえ。 \n  \n俺の冒険は終わったわけさ。 \n
ElzixGossip1	48 \n俺もよ、色々やってるウチに眼やら脚 \nやらなくしてよ... \n  \nコイツをもっぺん生やす呪文はねえか？ \nそうか、じゃ、やめとくわ。 \n
ElzixGossip2	90 \nドログナンが口を開くことがあったら、 \n聞き逃さねえよう気をつけな。 \n
ElzixGossip3	80 \n砂漠にゃ古墳がゴマンとある。だいた \nいは盗掘されてるが、中にゃまだ手つ \nかずのもあるかもよ。 \n
ElzixGossip4	63 \nここで働いてた商売女が消えちまった \nのは残念だな。 \n  \n騒動が起こると、みぃんな宮殿に引っ \n込んじまってよ。それからいっぺんも \n出てこねえんだ。グレイズと傭兵ども \nが魔物を追っ払った後でもだぜ。 \n
ElzixGossip5	71 \nアトマは、いい女なんだがなあ。最近 \nは復讐のことしか考えてねえ。無理も \nねえがな。 \n
ElzixGossip6	62 \nこの街が何とかやっていけてんのは、 \nジェリンのお陰だ。でもあの兄ちゃん、 \n何か考えてるみてえだけどな。 \n
ElzixGossip7	88 \nゲグラッシュは、戦えるなら自分の影 \nでも倒そうっていう大バカ野郎さ！ \n
ElzixGossip8	74 \nメシフはかなり、切れる船長だぜ。ブ \nリキを銀に変えて、クソからマコトを \n引き出す事もできる。 \n
ElzixGossip9	63 \nファラはいい女だね。いつも淋しそう \nだが昔の話はしねえ。弱い者や貧乏人 \nの味方で、人助けもよくやってるよ。 \nなかなかできるこっちゃねえ。 \n
ElzixGossip10	70 \nライサンダーは偏屈なオヤジでな。ポ \nーションを調合してる時ゃ話しかけん \nなよ。でないと、月まで吹っ飛ばされ \nっぞ。 \n
WarrivAct2IntroGossip1	62 \n君がアンダリエルを倒してくれたお陰 \nで、この街と修道院の通商ルートが再 \n開できた。取り引きが終わったら我々 \nは修道院に戻るから、ついて来たい時 \nは言ってくれ。 \n
WarrivAct2Gossip1	100 \nキャラバンは同行者を歓迎するが、そ \nれも目的地までだ。 \n
WarrivAct2Gossip2	80 \nここより東に向かうなら、船しかない。 \nメシフ船長が港に小さな商船を停めて \nいるはずだよ。 \n
WarrivAct2Gossip3	70 \nこの街にはもっと遊女が多かったと思 \nうが...魔物に怯えて出てこられないの \nか、それともジェリン様の宮殿は「安 \n全」なのか... \n
WarrivAct2Gossip4	50 \nエルジックスは油断ならない男だ。何 \n年か前には、彼の山賊に一財産もって \n行かれた。まさかこんな、落ち着いた \n姿を見ることになるとは思わなかった \nが。 \n
WarrivAct2Gossip5	53 \nジェリン様は先代の知恵と力をよく受 \nけ継いでおられる。すでに名君の素質 \nが見えるし、いずれ偉大なスルタンに \n育たれるだろう...この危機さえ生き延 \nびれば。 \n
AtmaIntroGossip1	56 \nごめんなさいね、取り乱してて。最近 \nつらいことがあったもんだから。 \n  \nあなたみたいな戦士が来てくれるのは \n頼もしいわね。私はアトマ。このラッ \nト・ゴーレインで酒場をやってるの。 \n
AtmaGossip1	86 \nここもいつ魔物に滅ぼされるか...あな \nたが頼りなのよ。 \n
AtmaGossip2	56 \n前は、このパブも繁盛してたのよ。魔 \n物に襲われた時、運良く卵はいっぱい \n守れたんだけど、もっと大事なものを \nなくしちゃってね...。 \n
AtmaGossip3	54 \n前はこの店でも娼婦が客を引いてたん \nだけど、砂漠に怪物が現れた途端、ハ \nーレム・ギルドのメンバーは残らず宮 \n殿に逃げ込んじゃったのよ。 \n  \nもちろん、ジェリンは保護を引き受け \nたわ。きっと今頃、いろんな「お礼」 \nをしてもらってるわね。 \n
AtmaGossip4	70 \nゲグラッシュは飲み過ぎることも多い \nけど、勇敢な人よ。最近のゴタゴタで、 \nお酒の量が増えたみたい。 \n
AtmaGossip5	60 \nエルジックスとは、ずっと前からうま \nくやってるの。あの人は泊まり客をこ \nこで飲ませて、私は酔った客をあそこ \nの寝床に送るわけ。宿賃代わりに道具 \nを置いていくお客もいるわ。 \n
AtmaGossip6	87 \nメシフはあんまり、来たことがないわ \nね。陸に上がるより、あのボロ船の方 \nが落ち着くみたい。 \n
AtmaGossip7	69 \nライサンダーは短気だけど、悪い人じ \nゃないわ。いつも薬をくれたのよ...息 \n子が病気になった時には。 \n
AtmaGossip8	78 \nドログナンは、よくわからない人ね。 \nいつでも古い巻物やなんかを読んでて。 \nきっと一生わからないわね。 \n
GeglashIntroGossip1	54 \n何だよ、ほっといてくれよぅ！ \n  \n確かにグレイズはよく門を守ってるが \nなぁ、アレぐらい俺にもできらぁな。 \n俺様の力を見たら驚くぜ。 \n
GeglashIntroBarGossip1	38 \nお、おめぇバーバリアンだろ。北の野 \n獣みてえに強いとかいう。街を救いに \n来たつもりなら無駄足だぜ。ここにゃ \n俺様がいるんだからよぅ。 \n  \n確かにグレイズはよく門を守ってるが \nなぁ、アレぐらい俺にもできらぁな。 \n俺様の力を見たら驚くぜ。 \n
GeglashGossip1	43 \nおめえらバーバリアンはいっぺんに二 \nつも武器を持つんだってな。俺にゃマ \nネできねぇ。片手に剣、片手に酒袋で \n精一杯だぁ。 \n
GeglashGossip2	50 \nそうそう、ハーレム・ギルドの話は聞 \nいたかぁ？　魔物が出てから、宮殿に \n入らせてもらった平民はあいつらだけ \nだぜ。 \n  \nわかるけどな。 \n
GeglashGossip3	62 \n砂漠で怪物をずいぶん殺したんだが、 \n斬っても斬ってもキリがねぇや。１匹 \nやったら10匹増えやがる。 \n
GeglashGossip4	52 \nサンド・マゴットとは戦ったかい？　 \n奴らにゃ、弓なんかはあんまり効かね \nえぞ。やっぱ剣とかだな。 \n
GeglashGossip5	54 \n砂漠にゃ古墳がいっぱいあるんだ。こ \nっからじゃかなり遠いけどな。何でも \n最近じゃ、歩く死体が出てるらしいぜ。 \n \n  \nクロウ・ヴァイパーやセイバーキャッ \nトだけでも厄介なのに。 \n
GeglashGossip6	64 \nメシフはいい奴だが、アイツの船にゃ \n死んでも乗らねえ。水の事なんざ考え \nたくもねぇんだ。 \n
GeglashGossip7	52 \n最近ジェリンは変だよ。どうして守備 \n兵を宮殿から出さねぇんだか。中で何 \nかモメ事があるにしても、俺様は呼ん \nでほしくねぇな。 \n
GeglashGossip8	54 \n前に、ファラが酔っぱらったゴロツキ \nを何人も倒すのを見たぜ。そりゃスゲ \nエもんだった。昔の事ぁ知らねえが、 \nあの女大した腕だぜ。 \n
GeglashGossip9	83 \nライサンダーにゃ用はねえ。老いぼれ \n錬金術師じゃ戦いの役に立たねぇよ。 \n
MeshifIntroGossip1	60 \nやあ、私はメシフ。この船の船長だ。 \n主に双子海あたりを渡るが、ウェスト \nマーチのキングスポートまで足を伸ば \nすこともある。 \n  \nだが最近は航海に出られない。不測の \n事態に備えて船を待機させろと、ジェ \nリン様からのお達しでね。 \n
MeshifIntroAmaGossip1	48 \nやあ、アマゾンさん。君の一族と会う \nのは久しぶりだよ。君らほどの戦士が \n街を守ってくれるとは、ありがたい。 \n \n  \n私はメシフ。この船の船長だ。主に双 \n子海あたりを渡るが、ウェストマーチ \nのキングスポートまで足を伸ばすこと \nもある。 \n  \nだが最近は航海に出られない。不測の \n事態に備えて船を待機させろと、ジェ \nリン様のお達しでね。 \n
MeshifGossip1	59 \nクラストの噂を聞かないかね？　君ら \nアマゾンは方々に旅するんだろう？　 \n最近あっちへは行ってないか？ \n  \nそうか。早く港が開いてくれないかな。 \nクラストに帰りたくて仕方ないんだが。 \n  \n
MeshifGossip2	70 \nジェリン様は何か隠している。見たと \nころ、ワリヴのキャラバンが交易を再 \n開してからこっち、街の様子はかなり \n落ち着いてきたんだがな。 \n
MeshifGossip3	62 \nこのへんの海ならよく知ってるさ。こ \nの時季、西に船を出すのは危ないね。 \n季節が変わる前にウェストマーチへ向 \nかいたいなら、キャラバンに同行して \n砂漠を渡るほうがいい。 \n
MeshifGossip4	75 \n今、この船で行けるのは東だけだ。た \nだしジェリン様に、事態が落ち着くま \nで出航を禁じられているが。 \n
MeshifGossip5	63 \nエルジックスなら昔から知っているよ。 \nいつもタダで泊めてくれると言うんだ \nが、私は自分の船室の方が落ち着くん \nだな。 \n
MeshifGossip6	58 \nワリヴは親友だね。よくお互いの旅の \n話をする。もし人生をやり直せるとし \nても、私らはまた何か、旅する仕事に \nつくだろうな。 \n
MeshifGossip7	66 \nグレイズは頼りになる男だが、砂漠か \nらの総攻撃がある前に何とかして欲し \nいところだね。 \n
MeshifGossip8	130 \nアトマの店の酒はうまいよ。 \n
MeshifGossip9	68 \nゲグラッシュ？　人でも獣でも怖いも \nのはないと自慢する癖に、海の話をす \nると震え上がる男だろう。 \n
MeshifGossip10	130 \nファラにはどこか高貴な雰囲気があるね \nね。 \n
JerhynActIntroGossip1	34 \nようこそ、旅のお方。僕がジェリン、 \nこのラット・ゴーレインの領主だ。心 \nから歓迎しよう。西への交易路が再開 \nできて嬉しい限りだよ。 \n  \nだが今、街は謎の敵の攻撃を受けてい \nる。不思議なことに、すべては黒衣の \n放浪者が現れてから始まった。彼は、 \n魔神バールを封印している魔道師タル・ \nラシャの墓所を捜していた。墓所の正 \n確な所在は我々も知らないのだが、砂 \n漠の古墳群のひとつに違いない。 \n  \n最近では、死者が墓を抜け出して月夜 \nの砂漠をうろつくという噂もある。僕 \n自身、この眼で不可解なものを見た。 \nだから港を封鎖して、船を待機させて \nいるのだよ。万一の際の脱出用にと思 \nってね。 \n  \nそうそう、酒場の女将でアトマという \n者が、君を捜していたぞ。彼女の店は、 \n街の反対側にある。 \n  \nでは失敬して宮殿に帰らせてもらう。 \n悪いが招くことはできないのだ。今は \n少々、取り込み中でね。 \n
JerhynActIntroMoreGossip1	44 \n魔術関係の取り引きなら、ドログナン \nかライサンダーに会いたまえ。ドログ \nナンは大変な賢者で、魔術と伝説に精 \n通している。ライサンダーは哀れにも \n耳が遠いが、ポーション配合の達人だ。 \n  \n  \n西に戻るならワリヴに頼むのだな。 \n  \nファラは誇り高い防具商人だ。傷を癒 \nす能力もある。 \n  \nエルジックスは宿屋の亭主で、アイテ \nムも扱っている。 \n  \nグレイズは、ラット・ゴーレインの街 \nを守るために、僕が雇った傭兵だ。 \n  \n他にも君の役に立つ者はいるだろう。 \n捜してみるといい。 \n
JerhynIntroGossip1	114 \n一見平穏なこの街だが、事態は水面下 \nで刻々と悪化しているのだよ！ \n
JerhynGossip1	114 \n一見平穏なこの街だが、事態は水面下 \nで刻々と悪化しているのだよ！ \n
JerhynGossip2	60 \nラット・ゴーレインを救ってくれる者 \nには、協力を惜しまない。報酬も、名 \n声も、東への旅も、何でも提供したい \nと思っている。 \n
JerhynGossip3	71 \n君もかなりの使い手のようだが、失礼 \nながら軽々しく信用はできないな。情 \n報を漏らされてパニックが起こっても \n困るのでね。 \n
JerhynGossip4	85 \nエルジックスが元山賊なのは知ってい \nるが、デザート・レイン亭を持ってか \nらの彼はおとなしいものだよ。 \n
JerhynGossip5	76 \n君を連れてきたワリヴのキャラバンは、 \n実はかなり予定より遅れて着いたもの \nでね。もう駄目かと思っていた。 \n
JerhynGossip6	74 \nメシフは誇り高い男だが、僕が事情も \n話さずに出航を差し止めたので焦れて \nいるようだな。しかし事情は、どうし \nても話せないのだ。 \n
JerhynGossip7	98 \n酒場の女将のアトマは、仕事柄耳が早 \nいから情報源にいいかもしれない。 \n
FaraIntroGossip1	81 \n古代宗教の事ならよく知っているわ。 \n私は東方のクラストの街で、ザカラム \n教会のパラディンとして訓練を受けた \nもの。 \n
FaraIntroPalGossip1	103 \nようこそ、ブラザー。 \n  \n私はファラ。私も昔はザカラムの騎士 \nだったのよ。 \n
FaraGossip1	64 \nブラザー、いつかあなたのようなパラ \nディンが、教会の名誉と誇りを取り戻 \nしてくれることを願っているわ。 \n
FaraGossip2	57 \n砂漠のあちこちに、千年も前のほこら \nが残っているのよ。これは罪悪戦争の \n遺物で、あまり知られていないのだけ \nれど、実は今でも魔力を保っているわ。 \n  \n
FaraGossip3	50 \n売春婦は堕落を誘う職業だから、尊敬 \nはしないわね。でも、ハーレム・ギル \nドがずっと宮殿に引きこもっているも \nのだから、苛立っている者も多いよう \nね。 \n
FaraGossip4	62 \n太古に三魔王が倒されたとき、憎悪の \n王メフィストはクラストに移されて、 \n神聖な魔法で封印されたのよ。 \n
FaraGossip5	69 \nワリヴは覚えていないでしょうけれど、 \n私がまだ若いパラディンだった頃、彼 \nを助けた事があるのよ。知らせる必要 \nはないわ。現世での報酬に興味はない \nから。 \n
FaraGossip6	68 \nグレイズは有能な指揮官だけれど、心 \nはいつも傭兵ね。自分を信用しない者 \nを、完全に信用することはできなくて \nよ。 \n
FaraGossip7	90 \nアトマはいい女性なのだけど、絶望と \n憎しみに沈んでしまわないか心配ね。 \n
FaraGossip8	95 \nゲグラッシュは力を過信しているわ。 \n真の強さは胸の内に宿るというのに。 \n
FaraGossip9	94 \n私の知る限り、メシフは誠実な人ね。 \n他人の過去を聞き出そうともしない。 \n
LysanderIntroGossip1	61 \n何者じゃ？　何をしに来た？ \n  \nもし宿屋のエルジックスのような悪党 \nでも、ポーションが欲しければわしに \n頼るしかないぞ。もちろん、相応の代 \n金は払えよ。 \n
LysanderGossip1	109 \nポーションは繊細な芸術なのじゃ。人 \nと同じく、見かけではわからん。 \n
LysanderGossip2	65 \nアトマか。砂漠に咲く一輪の花じゃの。 \nじゃがいくらわしの薬でも、あの子の \n家族は生き返らん。 \n
LysanderGossip3	83 \n砂漠には、傷を癒す魔力を持った古代 \nの井戸もあるぞ。見つけたら水を飲ん \nでみるんじゃな。 \n
LysanderGossip4	71 \n耳が遠いのも考えようによっては便利 \nなものじゃ。くだらん噂話に悩まされ \nんですむ。 \n
LysanderGossip5	50 \n夜の女を買った事はないが、みな宮殿 \nに隠れてしまってからというもの、目 \nの保養ができんのは残念じゃなあ。 \n
LysanderGossip6	95 \nグレイズは頼りにしとるよ。あの男な \nら大丈夫じゃろう。 \n
LysanderGossip7	90 \nワリヴにはよくポーションを売ってお \nる。西に運べば高く売れるらしいな。 \n
LysanderGossip8	60 \nメシフには昔から、船酔い止めのポー \nションを卸しとる。外海の揺れに音を \n上げる乗客が多いとかでな。 \n
LysanderGossip9	54 \nジェリンには以前から軽い媚薬を納め \nておった。ハーレムの娘相手に使うよ \nうじゃな。 \n  \nところが娘どもが宮殿に逃げ込んでか \nらは、パッタリ来んようになってな。 \nま、経験にまさる薬はなし、というと \nころかの。 \n
LysanderGossip10	52 \nドログナン？　一番の友達じゃよ。あ \nやつの持ち込む古代薬の処方を再現し \nたり、錬金術書を読んでやったりしと \nる。かなり力のある魔道師じゃろうと \nにらんでおるが、昔の話はしたがらん \nな。 \n
DrognanIntroGossip1	58 \n聞くところによると、君があのアンダ \nリエルを地獄に送り返したそうだね。 \nさぞ大変だったことだろう。 \n  \n私はドログナン。君の敵のことはよく \n知っているつもりだ。 \n  \n私のアイテムを見ておいたほうがいい。 \n  \n
DrognanIntroSorGossip1	42 \nラット・ゴーレインへようこそ、お若 \nいソーサレスさん。君が、この砂漠の \n恐怖に立ち向かえるほどの使い手だと \nいいがね。君ぐらい経験の浅い魔道師 \nは、えてして窮地に陥りがちだ。 \n  \n私はドログナン。君の敵のことはよく \n知っているつもりだ。 \n  \n私のアイテムを見ておいたほうがいい。 \n  \n
DrognanGossip1	71 \n女に魔術は不要と考える魔道師族も多 \nいが、君がここまで来られた事実を見 \nれば、それは誤りだと言わざるを得な \nいね。 \n
DrognanGossip2	51 \nホラドリムは確かに力のある集団だっ \nたが、自信過剰だな。タル・ラシャが \nいい例だろう。 \n  \nいくら何でも、魔王のひとりを体内に \n閉じこめようとは。いささか無謀な試 \nみと言うべきだ。 \n
DrognanGossip3	78 \n君の友人のケインも、ホラドリムの生 \nき残りだそうだね。彼の助言には、思 \nい上がりの危険が潜むのを忘れないこ \nとだ。 \n
DrognanGossip4	46 \n先般、トリストラムで死んだと思って \nいたビジェレイの同志が街に現れてね。 \n支離滅裂なことを口走っていたので、 \n話の内容は覚えていない。 \n  \nそれでも、どうしたわけかジェリンの \n宮殿に通されたらしいが、その後姿を \n見た者はいない。屋敷で、何かあった \nのだろうな。 \n
DrognanGossip5	64 \n私は、見かけよりずっと歳を重ねてい \nて、大層な昔から魔道の修練を積んで \nいる。だが術を操れぬほど老いぼれて \nもいない。 \n
DrognanGossip6	62 \nエルジックスは狡猾な男だが、私をだ \nまそうとはしない。私の力を知ってい \nるからだよ。 \n
DrognanGossip7	86 \n魔獣はもはや砂漠に満ちて、この美し \nい港町を取り囲む勢いだな。 \n
DrognanGossip8	88 \nメシフの船出を許してはいけない。魔 \n物が密航して被害が拡大したらどうな \nる。 \n
DrognanGossip9	52 \nこの騒ぎが持ち上がった直後、ジェリ \nン卿が助言を求めてきた。私は、港の \n封鎖と戒厳令を勧めた。 \n  \nだが最近彼は、宮殿を出ないのだ。い \nかに手練れの娼婦でも、あの男をこう \nも長く公務から引き離せるとは思えな \nいが。 \n
DrognanGossip10	61 \nライサンダーはまあ、罪のない男だな。 \n互いの利益のために協力することも多 \nいが、彼に現状を打破できるほどの能 \n力はない。 \n
CainAct2Gossip1	40 \nやあ、ジェリンとは会ったかね？　若 \nいのに、しっかりした領主だ。やはり \n血筋というべきかな。 \n
CainAct2Gossip2	71 \nファラはどうも気にかかる。砂漠の民 \nにしては、どこか物腰が変わっておる。 \n  \n
CainAct2Gossip3	70 \nエルジックスは悪党だが面白い男だ。 \n
CainAct2Gossip4	52 \nカンジュラスからの旅の間、ワリヴと \nずいぶん話したが、彼は砂漠の危険に \n精通しておるよ。君も話を聞いておい \nた方がよかろう。 \n
CainAct2Gossip5	52 \nメシフは興味深い人物だね。常に自由 \nの海を求める一方で、心のどこかは故 \n郷に縛られておるのだな。 \n
TyraelGossip1	32 \nかたじけない、やっと自由になれた。 \nだが、遅かったな。 \n  \n我は大天使ティラエル。バールの封印 \nを解こうとするディアブロを止めんと \nして、返り討ちにあった。今は恐怖と \n破壊の二大魔王が自由に地上を歩いて \nおる。 \n  \nきゃつらは今まさに、東の都クラスト \nの、ザカラム教会の総本山に向かって \nおろう。かの地に封印された長兄、憎 \n悪の王メフィストを解放するつもりで \nな。 \n  \nそれだけは、いかなる犠牲を払おうと \nも阻止せねばならぬ。もし三魔王が揃 \nえば、もはや立ち向かうすべはあるま \nいからな。 \n  \nなれど我は傷つき、地上に長くとどま \nる力すらない。 \n  \n冒険を続け、三魔王の再会を阻め。海 \nを渡り、クラストでディアブロやバー \nルと戦うのだ。 \n  \n急げ、人間よ...時間は残り少ない！ \n
Desert2GuardGossip1	50 \nおいおい、今街を出るのは感心しねえ \nぞ！ \n
A2Q1InitAtma	42 \n引き受けてくれとは言えないけれど、 \n聞いて欲しい話があるの。 \n  \n街の地下の下水道に、人喰いの怪物が \n巣くっているの。これまで、何人も殺 \nされたわ。私の息子と夫もやられた。 \n \n  \nこの怪物を滅ぼしてくれたら、お礼し \nます。でも気をつけて、もう誰にも死 \nんでほしくないの。 \n  \n下水道の入口は、この道の突き当たり \nのトラップ・ドアよ。 \n
A2Q1AfterInitGreiz	46 \n下水の魔物にやられた人間なら、何度 \nも見たぜ。たいてい腕か脚か頭が切り \n取られてて、必ず皮を剥いであったな。 \n  \n  \n最初、奴は夜中に街を荒らした。アト \nマの家族がやられたのはそん時さ。そ \nれで俺達が地下に追い込んだ。 \n  \n今は地上にいりゃ安全なんだが、時々 \n英雄気取りのバカがのこのこ降りてっ \nて、流されてくることになるわけだ。 \n
A2Q1AfterInitElzix	64 \n怪物は獲物の手足を切り落とすそうじ \nゃねえか。俺は会いたかねえな。これ \n以上斬られたら手も足も出ねえ。 \n
A2Q1AfterInitWarrivAct2	80 \n夜に砂漠を歩く死者の噂なら聞いてい \nるが、実際に見たことはない。 \n
A2Q1AfterInitGeglash	77 \n指で頭に穴あけっぞぉ！ \n
A2Q1AfterInitFara	40 \nその怪物というのは、砂漠に葬られた \n古代ホラドリムのミイラだと思うわ。 \nでも、ミイラが自分の墓所をこんなに \n離れるなんて、おかしいわね。 \n
A2Q1AfterInitAtma	60 \n魔物は街の地下トンネルに住んでるわ。 \n夫と息子も奴に殺されたの。ごめんな \nさい、これ以上話すのはつらい... \n
A2Q1AfterInitMeshif	60 \n下水の入口なら２つある。ひとつはこ \nの近く、ドックの水面近くだ。この船 \nから見えるよ。もちろん夜には警戒を \nおこたらない。 \n
A2Q1AfterInitDrognan	48 \nファラとも相談して研究したんだが、 \nこの怪物の正体は多分、古代ホラドリ \nムのミイラの１人、「堕落せしラダメ \nント」だろうと思う。墓所を離れて人 \n間を襲う理由は定かではないがね。 \n  \nまだ研究は続けているから、また何か \nわかるかもしれないよ。 \n
A2Q1AfterInitLysander	90 \n怪物は人の手足を集めるそうじゃの。 \nやっぱり喰うんじゃろうか？ \n
A2Q1AfterInitCain	43 \nホラドリムには大魔道師をミイラ化し \nて呪文をかける習慣があったが、それ \nは偉大な賢者が死後も身を守れるよう \nにするためだ。 \n  \n偉人のミイラがなぜ害をなすのか、わ \nしには見当もつかん。ドログナンやフ \nァラの方が事情に詳しいだろう。 \n
A2Q1EarlyReturnWarrivAct2	90 \n死者は生者を恐れぬが、生者は死者に \nおののく。 \n
A2Q1EarlyReturnMeshif	55 \n今朝、腐りかけた人間の腕が港に浮い \nているのを見つけた。あわててグレイ \nズに知らせたが、最近行方不明者は出 \nていないと言って取り合ってくれない \nんだ。 \n
A2Q1EarlyReturnAtma	80 \nやっぱり、頼んだのは間違いだったか \nしら...私のせいであなたが死んだらと \n思うと、気が気じゃなくて。 \n  \n気をつけて。 \n
A2Q1EarlyReturnGreiz	69 \n地下に突入隊を送ってバケモノを殺す \n案もあったんだが、かなり危ねえだろ。 \n砂漠が面倒なときにこの上兵隊が減っ \nちゃたまんねえから、オアズケになっ \nてんだよ。 \n
A2Q1EarlyReturnGeglash	62 \nおぅ、命の水で元気づけかい？　でも \n長くはもたねぇぞ。 \n  \nおい、酒だぁ！ \n
A2Q1EarlyReturnElzix	67 \nあの魔物と戦うんなら、アンデッド対 \n策はしっかりしとけよ。例えば毒なん \nか、奴にゃあんまり効かねえぞ。 \n
A2Q1EarlyReturnLysander	60 \nん、ペパーミント？　あ、ラダメント \nか。そうそう、あの怪物な。 \n  \nわしの爆発ポーションならよう効くぞ。 \nアンデッドにはこれが一番じゃ。 \n
A2Q1EarlyReturnDrognan	41 \nくだんのアンデッドについて、面白い \n文献を見つけたよ。ホラドリムは遺体 \nをミイラにするとき、魔法と手術で体 \nの部品を動物のものに取り替えていた \nらしいのだ。 \n  \nそうすると魔力が増強され、死後の地 \n位が上がるのだそうだ。 \n
A2Q1EarlyReturnFara	62 \n今日、ドログナンが面白い話をしてい \nたわ。これで、ラダメントが人間の手 \n足を集める理由がわかるかもしれない。 \n  \n
A2Q1EarlyReturnCain	36 \nホラドリムのミイラは本来、自分の墓 \n所を守るものなのだが、ラダメントは \n棺から遠く離れておるのだな。これだ \nけ異常な事態が続くとあれば、他の墓 \nの封印が解けていても不思議はない。 \n気をつけるのだぞ。 \n
A2Q1SuccessfulGreiz	71 \nラダメントを殺したって？　大したも \nんじゃねえか。傭兵になる気があった \nらいつでも俺に声かけてくれや。 \n
A2Q1SuccessfulDrognan	48 \nどうやら聞いた限りでは、ラダメント \nは生者の肉体を継ぎ合わせて、加工さ \nれた自分の体を元に戻そうとしていた \nようだな。 \n  \n前代未聞だよ。アンデッドの意志をね \nじ曲げるには、想像を絶する魔力が必 \n要なはずだ。 \n  \n私などでは到底及ばぬほどの力がね。 \n
A2Q1SuccessfulLysander	57 \n世の中、聞くに値するほどの話は滅多 \nにないもんじゃが、ラダメントが死ん \nだとの知らせは例外じゃな。アトマも \n喜ぶじゃろ。 \n
A2Q1SuccessfulMeshif	60 \n凄いな君は！　実は毎晩、あの怪物の \n声に起こされてたんだが、これでぐっ \nすり眠れるよ。 \n
A2Q1SuccessfulGeglash	35 \nへえぇ...「堕落せしラダメント」なぁ。 \n \n  \n俺ぁ何べんも酒場のイスから落ちてん \nだけど、誰も「転落せしゲグラッシュ」 \nなんて名前じゃ呼ばねぇなあ。 \n
A2Q1SuccessfulElzix	67 \n山賊だった頃にあのテのミイラと戦っ \nたこともあるが、面倒な相手だった。 \nあんたにゃ一目置かせてもらうよ。ア \nトマにゃもう会ったかい？ \n
A2Q1SuccessfulWarrivAct2	142 \nアトマは大喜びで、君をほめているよ。 \n  \n
A2Q1SuccessfulFara	102 \nあなたはアトマと街の恩人ね。私も協 \n力するわ。 \n
A2Q1SuccessfulCain	57 \nまだなら、早くアトマにラダメントを \n倒したと言ってやれ。きっと喜ぶだろ \nう。 \n
A2Q1SuccessfulAtma	45 \n復讐の味は苦いという人もいるけど、 \n私は気に入ったわ。 \n  \nありがとう、心から感謝します。つい \nでと言っちゃなんだけど、街の商人み \nんなに頼んで、あなたと取り引きする \n時には値を下げてもらえる事になった \nから。ほんのお礼のしるしよ。 \n  \nそうそう、ジェリン様がお呼びよ。宮 \n殿に行ってみて。 \n
A2Q2EarlyReturnScrollCain	33 \nこれは伝説の、ホラドリムの巻物だ！　 \n何たる幸運か！ \n  \nこれを読めるのは、ホラドリムの生き \n残りであるわしだけだ。待て待て、今 \nから聞かせてやろう。 \n  \nタル・ラシャが魔王バールを体内に捕 \nらえた後、同行していたホラドリムの \n魔道師達が魔法でその墓室を封印した。 \nそして彼らは何本かのホラドリムの杖 \nを作り、墓室への隠し扉を開く魔法の \n鍵としたのだ。 \n  \nしかし、その杖が悪人に盗まれそうに \nなったため、魔道師達はさらに用心し \nて、全ての杖を金属の頭部と木材のシ \nャフトに分けた。それから、それぞれ \n別の場所に隠したのだ。 \n  \n先人は、今のような危機があることを \n予見して、君のような勇者だけに扉を \n開けられるようにしたのだな。 \n  \nホラドリムの杖の部品を集め、ホラド \nリムのキューブを使って合体させれば、 \nタル・ラシャの墓室に入れる。 \n
A2Q2EarlyReturnCapCain	45 \n君が持っておる「毒蛇の護符」こそ、 \nホラドリムの杖の頭部だ！ \n  \n君はよくよく、秘宝を探し当てる才能 \nに恵まれておるな。無論、これをシャ \nフトと合体させるには、ホラドリムの \nキューブが必要だが。 \n
A2Q2EarlyReturnStaveCain	52 \n王者の杖！　驚いたな、これこそホラ \nドリムの杖のシャフトにあたる部品だ \nよ！ \n  \nシャフトと頭部を組み合わせる際、ホ \nラドリムのキューブをどう使うかは知 \nっておるだろうな。 \n
A2Q2EarlyReturnCubeCain	44 \nホラドリムのキューブは、大変価値の \nある遺物だ。まず、ホラドリムの杖を \n組み立てるのに用いられる。 \n  \n使うには、まずキューブを巻物と同様 \nの手順で開く。それから２つの部品を \n入れ、キューブの合成能力を発動させ \nる。 \n  \n他にもアイテムの合成や変成に使える \nぞ。 \n  \n同種で同質の宝石を３個入れて合成す \nれば、同種で一段質の高い宝石が１個 \nできる。 \n  \n６個の宝石と１本の剣で、ソケットつ \nきのソードに。 \n  \nクロスボウのボルト２つを弓の矢筒ひ \nとつに、弓の矢筒ふたつをクロスボウ \nのボルトひとつにも変えられる。 \n  \n  \n他にも機能があるはずだ。試してみた \nまえ。 \n
A2Q2SuccessfulStaffCain	40 \n素晴らしい、ホラドリムの杖だ！ \n  \nこれをタル・ラシャの墓所に持って行 \nき、床に７つの紋章の環が描かれた場 \n所を探せ。 \n  \nそこの、しかるべき場所に杖を納めれ \nば、タル・ラシャの墓室への扉が開く \nだろう。 \n  \nしかし、用心せよ。大魔道師の体に入 \nった魔王バールと戦うのだからな。 \n
A2Q3AfterInitJerhyn	105 \n宮殿の天文学者も、この日蝕には驚い \nている。ドログナンに会いたまえ。 \n
A2Q3AfterInitGreiz	67 \n昼間から真っ暗とは、とんでもねえ魔 \n法だな。俺達で何とか抑えてるが、街 \nの住人はパニック寸前だぜ。 \n
A2Q3AfterInitElzix	60 \nゆうべ遅く来た男２人の客が、怪しげ \nな魔法の儀式を見たとか言ってたぜ。 \nでっかい蛇のバケモノが集まって何か \nしてたって。砂漠のヘビ人間かもな。 \n
A2Q3AfterInitWarrivAct2	68 \n太陽は、地上の醜さに気分を害したの \nではないだろうか。だとすれば、我々 \n全員の責任だ。 \n
A2Q3AfterInitAtma	117 \nドログナンならきっと、何かわかると \n思うわ。 \n
A2Q3AfterInitGeglash	100 \n街中、黒ビールみてえな色だな。 \n
A2Q3AfterInitFara	67 \nこの闇は、邪悪な魔法の産物に違いな \nいわ。すぐドログナンに相談してごら \nんなさい。 \n
A2Q3AfterInitLysander	62 \nクロウ・ヴァイパーじゃよ！　賭けて \nもいい、この闇は連中の暗い魂の表れ \nに違いあるまい。奴らはよこしまで恐 \nろしい種族じゃ。 \n
A2Q3AfterInitDrognan	71 \nこの異常な日蝕を研究したが、半人半 \n蛇のモンスター種族、クロウ・ヴァイ \nパーたちの仕業に間違いないと思うな。 \n  \n  \n砂漠の地下にある彼らの寺院を見つけ \nれば、手がかりが得られるかもしれな \nい。 \n
A2Q3AfterInitMeshif	73 \nいつまでも暗いのは困るが...ずっと星 \nが観測できるから、航海は楽になるな。 \n  \n
A2Q3AfterInitCain	60 \nこの件はドログナンに相談した方がい \nい。わしも後で、会っておくとしよう。 \n  \n
A2Q3EarlyReturnJerhyn	130 \nこの日蝕は邪悪の業か！ \n
A2Q3EarlyReturnGreiz	73 \n街は心配すんな、俺達でガッチリ守っ \nてる。あのいまいましいクロウ・ヴァ \nイパーの連中と一戦交えるってんなら、 \n手を貸してもいいぜ。 \n
A2Q3EarlyReturnWarrivAct2	70 \nクロウ・ヴァイパーは、爬虫類独特の \n冷徹な頭脳を持った侮れない敵だ。 \n
A2Q3EarlyReturnGeglash	49 \n朝も昼も夕方もずっと夜ってなぁ、調 \n子狂っちまうなぁ！ \n
A2Q3EarlyReturnMeshif	105 \n闇はもう沢山だ。昼の景色がどんなも \nのだったかも忘れてしまったよ。 \n
A2Q3EarlyReturnFara	73 \nクロウ・ヴァイパーたちは邪悪な魔術 \nを使うわ。旅人をさらって暗黒神のい \nけにえに捧げることもあるそうよ。 \n
A2Q3EarlyReturnLysander	80 \n実を言うと、わしもクロウ・ヴァイパ \nーどもの生態についてはよく知らんの \nじゃ。ドログナンなら、この日蝕を起 \nこした術の事も知っておるかもな。 \n
A2Q3EarlyReturnDrognan	48 \n何百年も昔に、今と同様の日蝕が起こ \nったという記録を見つけたぞ。砂漠に \n住まう蛇の魔獣が邪悪の祭壇を築いた \nために、太陽が長らく陰ったという話 \nだ。 \n  \n今回も同じ原因だとすれば、クロウ・ \nヴァイパーの寺院を見つけ、祭壇を捜 \nす事だな。 \n
A2Q3EarlyReturnElzix	94 \nウチの宿賃は一晩いくらなんだが... \n  \n何か、別の目安を作らにゃならんな。 \n
A2Q3EarlyReturnCain	57 \nこの術の源泉は魔法の祭壇だと思う。 \n術を解くには、クロウ・ヴァイパーど \nもを殺すだけでは駄目だ。祭壇を見つ \nけて破壊せねば。 \n
A2Q3EarlyReturnAtma	80 \nずっと時刻がわからなくて困るわ。い \nつでも夜明け前みたいな気がして落ち \n着かないのよ。 \n
A2Q3SuccessfulJerhyn	96 \n再び太陽が戻った！　感謝するぞ！ \n
A2Q3SuccessfulGreiz	219 \nやったな！ \n
A2Q3SuccessfulElzix	74 \nお天道様のありがたい光が、片方だけ \n残った眼にしみるぜ。 \n
A2Q3SuccessfulGeglash	60 \nたかが昼だろ。騒ぐなよ。 \n
A2Q3SuccessfulWarrivAct2	80 \n再度の陽光のもと、人々はあわてて体 \n裁を取りつくろう。暗い部屋に脱ぎ散 \nらかした下着をかき集めるように。 \n
A2Q3SuccessfulMeshif	130 \nで、何か戦利品はあったかね？ \n
A2Q3SuccessfulAtma	132 \nありがとう、お陰で助かったわ。 \n
A2Q3SuccessfulFara	87 \n今回の件で、ドログナンもあなたを信 \n用する気になったみたい。彼の知識は \n頼りになるわよ。 \n
A2Q3SuccessfulLysander	69 \nそうそう、クロウ・ヴァイパーどもは \n魔法のアイテムが好きじゃからな。何 \nか見つけてきたか？ \n
A2Q3SuccessfulDrognan	69 \nよくぞクロウ・ヴァイパーの一族を倒 \nしてくれた。陽の光が戻って、みな喜 \nんでいるよ。 \n
A2Q3SuccessfulCain	42 \nさっきジェリン卿とお会いしたが、何 \nか大きな悩みを抱えておいでの様子だ \nった。君も行ってみるといい。 \n  \nまだ通してもらえないなら、信用が足 \nりんのだろう。もっと働いて誠意と腕 \n前を示すことだ。 \n
A2Q4InitDrognan	33 \n思いつく限りの古文書を広げてタル・ \nラシャの墓所の位置を探っているが、 \nまだ見つからない。だが、手がかりは \nあったよ。 \n  \nホラゾンという古代ビジェレイの偉大 \nな召喚術師が、この付近に「秘密の聖 \n域」という特殊な空間を築いて隠棲し \nた。外とは時間の流れが異なるその地 \nで、彼は召喚した魔獣を奴隷として使 \nい、また外部の重大事件を観察したと \nいう。例えば、タル・ラシャがバール \nを捕らえる場面なども見たはずだ。 \n  \nそのホラゾンの聖域を探り当てること \nができれば、タル・ラシャの墓所の手 \nがかりも得られると思う。ただし気を \nつけるのだな。ホラゾンが存命かどう \nかは怪しいが、中に何が待っているか \nは誰も知らない。 \n  \nジェリン卿にこの話をしたら、君を急 \nいで宮殿に寄越せと頼まれた。秘密の \n入口でも知っているのではないかね。 \n
A2Q4AfterInitFara	40 \n魔神を意志の力で従えようとした、大 \n魔道師ホラゾンね。愚かだわ。悪魔が \n人を使うことはあっても、その逆はな \nいのに。 \n  \nビジェレイでは、今も彼を強い意志の \n象徴としてあがめているけれど、ザカ \nラム教会では思い上がりの見本とされ \nているわ。 \n
A2Q4AfterInitGreiz	89 \nジェリンの地下室に何があるかって？　 \n逃げ込んだハーレム娘の群れに決まっ \nてるだろ。 \n
A2Q4AfterInitElzix	54 \n宮殿の下に「秘密の聖域」だって？　 \n古い地下室を宝物庫やなんかに使って \nるとは聞いたが、そいつぁ初耳だな。 \n
A2Q4AfterInitJerhyn	41 \n騒ぎが始まった日、怯えたハーレム・ \nギルドの女達を宮殿の地下室に避難さ \nせた。その時は親切のつもりだったの \nだが... \n  \nある晩、地下から凄まじい悲鳴が響い \nた。衛兵が駆けつけた時には、哀れな \n娘達は残らず地獄の魔獣に引き裂かれ \nていた。それから、宮殿は戦場に変わ \nった。敵の大群が地下から次々と現れ \nるのだ。 \n  \n衛兵は勇敢に立ち向かったが、しかし \n絶望的な戦いだった。すぐに手が足り \nなくなり、街の守備兵まで駆り集めて、 \n外はグレイズ率いる傭兵に任せるほか \nなくなった。 \n  \nラット・ゴーレインの街は、古代ビジ \nェレイの砦の上に築かれた。ドログナ \nンの言うとおり、宮殿の地下に秘密の \n聖域があるのかも知れない。 \n  \n君の通行許可を出した。力を貸してく \nれ。 \n
A2Q4AfterInitCain	41 \n聖域を見つけたとしても、ホラゾンが \n生きているとは思えぬな。確かに彼は、 \n魔獣を自在に操るほどの力を持ってい \nたようだが、それでも地獄の軍勢の追 \n及を逃れることはできまい。 \n
A2Q4AfterInitGeglash	56 \nおいおい、俺様ぁたしかに大口ばっか \nり叩いてるが、魔物をペットにしよう \nと思うほどバカじゃないぜ。 \n
A2Q4AfterInitAtma	75 \n秘密の聖域？　ステキな名前じゃない \nの。一度入ったら出たくなくなるんじ \nゃない？ \n
A2Q4AfterInitWarrivAct2	73 \n賢明な旅人は山賊の眠りを妨げない。 \nホラゾンが姿を消したなら、追わぬ事 \nだ。 \n
A2Q4AfterInitLysander	44 \nホラゾンが姿を隠したのは、こき使わ \nれて怒った魔物から逃げるためじゃな。 \n召喚術師の末路はたいがい、逃げるか \n呪われるかじゃよ。有能すぎる者や望 \nみが高すぎる者は、長生きできんのじ \nゃ。 \n
A2Q4AfterInitDrognan	36 \n千年近く昔、ホラゾンはビジェレイの \n魔道師族の頂点に立つと、ビジェレイ \nの知識を縦横に駆使して地獄の魔獣を \n召喚し、屈服させた。 \n  \nだが彼ほどの術者といえども、部下を \n奪われた魔王の復讐だけは恐れたのだ \nよ。そこで避難所として、秘密の聖域 \nを築いたわけだ。 \n  \n外界から完全に遮断された空間に閉じ \nこもることで、地獄の追手から逃れる \nと同時に、不老不死となって研究を続 \nける事が可能になったと言われている。 \n  \n  \n彼はそこに優れた透視術の設備も用意 \nし、外部の歴史的事件を観察したとい \nう。だとすれば、タル・ラシャがバー \nルを封印した瞬間を目撃し、その位置 \nを記録しているのはまず間違いないだ \nろうな。 \n  \nその聖域は、このラット・ゴーレイン \nのどこかにあると思われる。宮殿に入 \n口がある可能性は高い。あの建物は、 \n古代ビジェレイの砦を改修したものだ \nからな。 \n
A2Q4AfterInitMeshif	53 \nホラゾンの伝説というのは古いものだ \nから、真偽は疑わしいね。どんな大魔 \n道師でも、そんな事が可能とは思えな \nい。 \n
A2Q4EarlyReturnElzix	63 \nジェリンの宮殿に通されたって？　騒 \nぎが始まって以来、一般人が入るのは \nあんたが最初だぜ。 \n  \nジェリンがピリピリしてる理由がわか \nったら、教えてくんねえか？ \n
A2Q4EarlyReturnJerhyn	40 \n一年近く前、東方の魔道師が訪ねてき \nた。多分、ビジェレイの者だと思う。 \n彼はこの街の歴史、特に宮殿の建築に \n興味があると言った。それで、僕が自 \nら宮殿を案内してやったのだ。 \n  \n地下室の通路にある古い封印の紋章を \n見つけた時、彼はたいそう興奮して、 \nしばらく１人で研究したいと言いだし \nたので、好きにさせた。 \n  \nところがやがて、彼は挨拶もせず姿を \n消した。おかしいとは思わないか？ \n
A2Q4EarlyReturnGreiz	61 \n最近どうして宮殿に入り浸ってんだ？　 \nまさか、魔物と戦うよりハーレムの女 \nに立ち向かう方が楽しくなった、なん \nて言わねえだろうな。らしくないぜ。 \n  \n
A2Q4EarlyReturnDrognan	63 \nタル・ラシャの墓所の情報は、ホラゾ \nンの日誌に記されているはずだ。急が \nないと、ディアブロが弟のバールを解 \n放してしまうぞ。 \n
A2Q4EarlyReturnLysander	68 \nホライゾン？　地平線なんか追っかけ \nてもキリがないぞ。あ、ホラゾンな。 \n \n  \n頭はいいが、その頭がおかしくなった \n男じゃな。 \n
A2Q4EarlyReturnFara	57 \nいくらホラゾンの聖域でも、魔王の眼 \nを誤魔化せたとは思えないわ。今ごろ \n中は恐ろしい状態のはずよ。踏み込む \nなら気をつけてね！ \n
A2Q4EarlyReturnGeglash	49 \n長年にわたって、気にくわねえ野郎を \nぶっとばし続けてきた俺様の経験によ \nるとだなぁ、道はたったの２つ、戦う \nか逃げるかだ。他はそのバリエーショ \nンだぁな。 \n
A2Q4EarlyReturnMeshif	77 \n君、ジェリン卿と親しくなったのなら、 \n出港許可をもらえるよう嘆願してくれ \nないか？　もう我慢の限界だ。 \n
A2Q4EarlyReturnAtma	82 \n最近、宮殿に出入りしてるんでしょ？　 \nどうして一般人の出入りが止められて \nるのか、教えてよ。 \n
A2Q4EarlyReturnWarrivAct2	83 \n運命とは、檻の中の獣だ。もてあそぶ \nほど、後の報復が大きい。 \n
A2Q4EarlyReturnCain	46 \n君ももう気づいておるだろうが、宮殿 \nの件はかなり厳しい状況だな... \n  \n地下室が秘密の聖域への入口だとすれ \nば、魔物の出所は聖域ということにな \nる。ホラゾンの隠れ家は悪魔の手に落 \nちたわけだ！ \n
A2Q4SuccessfulNarrator	30 \nタル・ラシャの墓所へ至るには、魔法 \nのポータルを使うより他にない。ただ \nし、この聖域に集められた６個の紋章 \nは、いずれも偽りの墓所への鍵である \nと知れ。 \n  \n失われた第７の紋章こそが本物。ホラ \nドリム最大の魔道師、タル・ラシャの \n墓所の目印である。 \n  \nホラドリム。大いなる共通の敵を前に、 \n様々な魔道師族が協力して編成したこ \nの結社は、輝かしくも、哀しいほど短 \n命であった。 \n  \nホラドリムの面々は、時に東の帝国の \n廃墟へ、あるいは西の未踏の地へと分 \nけ入り、大天使ティラエルの力も借り \nぬまま、三魔王を次々と追い詰めてい \nった。 \n  \nだがやがて勝利の見通しが立つと、も \nとより強固とは言えなかったホラドリ \nムの結束は揺らいだ。彼らはソウルス \nトーンを護送するという重大な責務を \n軽んじ、ささいな思想や信条の違いか \nらいがみ合うようになった。 \n  \nこの内部抗争はついに結社の崩壊を招 \nき、封印された魔王達を力づける結果 \nとなってしまった。 \n
A2Q4SuccessfulGriez	53 \n信じられねえ！　ハーレムの女どもが \n全滅して、衛兵はみんな地下室の魔物 \nと戦ってたなんてよ！ \n
A2Q4SuccessfulJerhyn	62 \n我々を救ってくれて、本当にありがと \nう。心から感謝する。君が捜していた \nホラゾンの日誌も見つかったようで、 \n何よりだ。これでディアブロより早く \nタル・ラシャの墓所に入れればいいな。 \n  \n  \nそれでは、幸運を祈る。 \n
A2Q4SuccessfulDrognan	52 \nホラゾンの日誌を見つけたか。素晴ら \nしい...が、気を許すな。 \n  \n真のタル・ラシャの墓所の紋章は、デ \nィアブロも捜しているはずだ。まだ見 \nつけていなければな。 \n
A2Q4SuccessfulElzix	66 \n宮殿の噂はスゴイ勢いで広まってるぜ。 \nひでえもんだな。しかしジェリンと兵 \n隊達は、女と遊んでるとか陰口叩かれ \nながら、血みどろで戦ってたんだなあ。 \n  \n
A2Q4SuccessfulGeglash	60 \nそういうことなら、さっさと俺様を呼 \nびゃあよかったのに！　俺なら女を助 \nけて魔物をチョチョイと全滅させたぜ！ \n  \n
A2Q4SuccessfulMeshif	47 \nなるほど、ジェリン様の秘密とは、そ \nういう事だったのか。道理で出航を止 \nめられるわけだ。脱出の必要が生じな \nくて何よりだ。今はまた、君達を乗せ \nるために出航を待てと言われているん \nだが... \n  \n喜んで耐えよう。君の叙事詩に私の名 \nも出るかもしれんしね。 \n
A2Q4SuccessfulWarrivAct2	67 \n住民はみな、戸惑っている。知らぬ間 \nに全滅の危機にさらされ、知らぬ間に \n救われたわけだからね。 \n  \n今こうして我らがあるのも、君のお陰 \nだ。 \n
A2Q4SuccessfulFara	64 \n信仰は、何よりも堅固な防具なのよ。 \n盾は肉体を守るけれど、信仰は勇気を \n増してくれるもの。 \n
A2Q4SuccessfulLysander	55 \nホラゾンが必死？　あ、日誌な。見つ \nかってよかったの。しかし遊女は可哀 \n想に。ずいぶんさみしくなるわい。も \nちろん、声が聞けなくなって、じゃが。 \n  \n
A2Q4SuccessfulAtma	62 \n女の子達も気の毒にね。ひどい時代だ \nわ。それにしても、ありがとうね。 \n
A2Q4SuccessfulCain	51 \n急ぐのだ、ディアブロはそこまで迫っ \nておるかもしれんぞ。彼が破壊の王を \n解放する前に、何としてもタル・ラシ \nャの墓所を発見せねばならん！ \n
A2Q5EarlyReturnGreiz	89 \nホントにそんな風なのか？　そりゃホ \nラゾンがおかしくなったって言うより、 \nニセモノじゃねえか？ \n
A2Q5EarlyReturnJerhyn	52 \n君の言う人物はホラゾンではあるまい。 \n  \n  \nたぶん、以前宮殿を訪れた魔道師だろ \nう。この宮殿、特に地下室の封印に興 \n味を示した男だよ。その後すぐに姿を \n消したのだが、どうやって聖域に入れ \nたのだろうな？　封印は破れていなか \nったというのに。 \n  \n彼はドログナンと面識があったらしい。 \n彼の話を聞いてはどうかね？ \n
A2Q5EarlyReturnDrognan	42 \n確かにそれは、以前私を訪ねてきた男 \nだろう。トリストラムの地下道でディ \nアブロと戦ったとかいう突拍子もない \n話をしたので、取り合わなかったが。 \n \n  \n愚かにもホラゾンの聖域に迷い込んで、 \n残ったわずかな正気も失ってしまった \nに違いない。救いようのない奴だ。 \n \n  \nもしかすると、ホラゾンの魂に乗り移 \nられたのかもしれない。だったら、哀 \nれな命を絶って解放してやってくれ。 \n \n  \nそうすれば、召喚されて聖域にとどま \nっている魔物どもも地獄に帰ると思う。 \n  \n
A2Q5EarlyReturnLysander	50 \nああ、何か月か前、あんたみたいにホ \nラゾンの話を根掘り葉掘り聞いた旅人 \nがおったっけなあ。 \n  \nそれで奴はとうとう、ホラゾンの聖域 \nに入ったわけか？　大馬鹿者じゃな。 \n
A2Q5EarlyReturnMeshif	72 \nああ、いやしくも船長だからね、偽ホ \nラゾン現象はよく知っているとも。 \n  \nいや、嘘だ。すまん。 \n
A2Q5EarlyReturnWarrivAct2	99 \n砕かれた魂が操るのは、力よりも恐怖 \nである。 \n
A2Q5EarlyReturnAtma	105 \nあなた、いつもひどい事件にばかり関 \nわって大変ねえ。 \n
A2Q5EarlyReturnGeglash	33 \nホラゾンが狂ってたかって？　当たり \n前だろ。そんな何世紀も飲めずにいた \nら、誰だって飲まなくちゃ正気じゃい \nられねぇ...でも飲めねぇ。だから飲ま \nなくちゃ...えっと、何の話だっけ？ \n
A2Q5EarlyReturnFara	63 \nそれはどうも、ホラゾンらしくないわ \nね。いくら理性を失っていても、そん \nな様子とはとても思えないわ。ドログ \nナンに相談してごらんなさい。 \n
A2Q5EarlyReturnElzix	106 \n狂気の魔道師？　おっかねえなあ。 \n  \n頼むから、さっさと片づけてくれよな。 \n  \n
A2Q5EarlyReturnCain	40 \n姿形の特徴を聞く限り、トリストラム \nで会ったビジェレイの魔道師に似てお \nるな。当時あの街にはディアブロに挑 \nむ者が多く集まった。その中の１人だ。 \n  \n  \n魔王に立ち向かう者は、えてして凄惨 \nな報復を受ける。同じ道をたどらぬよ \nう、気をつけてくれよ。 \n
A2Q5SuccessfulGreiz	76 \nやっぱ、ホラゾンは死んでたのか。と \nにかくあんたの目的は果たせたんだな。 \n \n
A2Q5SuccessfulGeglash	60 \nなるほど、何だか...よくわかんねえや。 \n  \n
A2Q5SuccessfulJerhyn	63 \n汚された聖域からの魔軍は姿を消した。 \nまたしても、心から礼を言うよ。これ \nでみな、生活の再建に取りかかれる。 \n  \n  \nもっともその努力も、君が魔王を倒し \nてくれない限り水泡に帰すのだろうが \nね。 \n
A2Q5SuccessfulDrognan	83 \n大きな力が街に迫っておる。急いで墓 \n所を探してくれ！ \n
A2Q5SuccessfulElzix	65 \nあんたを見てると、昔に帰りたくなる \nぜ。両手と両目と両足がそろってた頃 \nによ。 \n
A2Q5SuccessfulWarrivAct2	84 \nこれから墓所に向かうのかね？　砂漠 \nの地下深くにあるという話だが。 \n
A2Q5SuccessfulMeshif	100 \nこれで準備はできたんだな。手遅れに \nならないうちに次も頼むよ。 \n
A2Q5SuccessfulLysander	103 \n悪魔をもてあそぶ者の末路は、いつも \nこうじゃよ。 \n
A2Q5SuccessfulAtma	89 \nあなたは、私が夢見た以上の勇者だわ。 \nこれでみんなも希望が持てそうね。 \n
A2Q5SuccessfulFara	74 \nその召喚術師には気の毒だけれど、あ \nんな惨事を引き起こした者には同情も \nできないわ。殺すしかなかったのね。 \n
A2Q5SuccessfulCain	48 \n君が哀れな召喚術師の魂を解放してく \nれたと願いたいが、やはりそのまま地 \n獄に引きずり込まれたのだろうなあ。 \n \n  \nよく覚えておくがいい。悪魔の術は魅 \n惑的で力強いが、引き返せぬ堕落へと \nつながるのだ。 \n
A2Q6InitJerhyn	45 \n君の勇気と力量は何度も見せてもらっ \nた。今こそ君を信じて、重大な秘密を \n打ち明けたいと思う。 \n  \n相談の結果、ドログナンと僕はある結 \n論に達した。最近この街を通った黒衣 \nの放浪者こそ、ディアブロ自身だ！　 \nドログナンの推測では、バールを封印 \nしたホラドリム最大の魔道師、タル・ \nラシャの墓所を探しに来たに違いない \nということだ。 \n  \nどうかディアブロに立ち向かい、この \n世界を覆う大いなる悪を打ち倒して欲 \nしい。ドログナンの知恵を借りて、タ \nル・ラシャの墓所を探り当てるのだ。 \n \n  \nただそれには、時間がかかる事だろう。 \nくれぐれも気をつけてくれ。 \n
A2Q6AfterInitJerhyn	47 \n奥深い砂漠の地下に、偉大なホラドリ \nムの墓所が７つ、隠されている。その \nうちのひとつがタル・ラシャの魂の牢 \n獄に違いないが、どれなのかはわから \nない。ひとつひとつ探検していくしか \nないかもしれない。 \n  \nその途上で、同じ場所を目指すディア \nブロとも出会うに違いない。彼が振り \nまく恐怖の力は、想像を絶する。 \n
A2Q6AfterInitElzix	59 \nあんた、あの７つの墓所を探そうって \nのかい？　でもありゃ、旅人がでっち \n上げた伝説だろ？　誰も本気で信じち \nゃいないぜ。 \n
A2Q6AfterInitWarrivAct2	57 \nくれぐれも気をつけてくれ、友よ。最 \n近の事件を見れば、墓所が実在するの \nは間違いない。となれば、恐るべき番 \n人が待ち受けているだろうから。 \n
A2Q6AfterInitAtma	67 \nタル・ラシャの墓所の伝説なら聞いて \nるけれど、ただのおとぎ話だと思って \nたわ。 \n
A2Q6AfterInitGeglash	59 \n俺様も、その墓に行ってやりてぇんだ \nが...アンデッドとはどうも、相性が悪 \nくてなぁ。 \n
A2Q6AfterInitMeshif	84 \n力になれなくてすまないね。その墓が \n海の彼方にあるなら、いくらでも相談 \nに乗るんだが。 \n
A2Q6AfterInitFara	57 \n伝説によれば、タル・ラシャは破壊の \n王を体内に捕らえ、永遠の戦いを続け \nているそうね。高潔ではあるけれど、 \n無謀な試みとしか思えないわ。 \n
A2Q6AfterInitLysander	48 \nタル・ラシャはバールを自分の体内に \n幽閉して、永遠に戦い続ける道を選ん \nだそうじゃが、しかし正直なところ、 \nそんな事をして勝ち目があると思うか？ \n  \n
A2Q6AfterInitDrognan	55 \nタル・ラシャの墓所は他の６つと同じ \nく砂漠の地下に隠されている。真の墓 \n所の目印は、彼の紋章だ。その紋章は、 \n秘密の聖域をよく調べれば見つかるは \nずだ。 \n
A2Q6AfterInitCain	57 \n急いでディアブロに追いつかねば。 \n  \nしかしアンダリエルの例を考えると、 \n地獄のあらゆる魔神がディアブロの命 \nを受けて我らを阻もうとするに違いな \nい。道は険しいぞ。 \n
A2Q6AfterInitGreiz	106 \n砂漠の奥地に行く気なら、ウチの兵隊 \nを連れてったらどうだい？ \n
A2Q6SuccessfulJerhyn	40 \nお見事だった。タル・ラシャの墓所を \n見つけただけでも、常人にはかなわぬ \n偉業だろう。ただ、ディアブロとバー \nルが姿を消した後というのは、つくづ \nく残念だな... \n  \n今から東へ向かうなら、メシフの船を \n使うといい。かの者も出航を心待ちに \nしている事だろう。 \n  \n街を救ってくれて、本当にありがとう。 \n幸運を祈る。いつでもまた、立ち寄っ \nてくれ。最大の歓迎を約束する。 \n
A2Q6SuccessfulElzix	71 \nディアブロに出し抜かれたって？　ま \nあでも、あんたならすぐ追いつけるさ。 \n野郎を地獄に送り返してやってくれよ！ \n  \n
A2Q6SuccessfulLysander	70 \n計画通りにいかんで残念じゃったな。 \n時々、この街も思い出してくれよ。あ \nんたほど怒鳴らんですむ客は滅多にお \nらん。 \n
A2Q6SuccessfulAtma	64 \nあなたみたいな勇者と知り合えたのは \n一生の誇りよ。街に平和を取り戻して \nくれて、ありがとうね。 \n
A2Q6SuccessfulWarrivAct2	68 \n悔やむことはない。君は最善を尽くし \nた。 \n  \nディアブロとバールは東のクラストへ \n向かったようだが、君ならきっと追い \nつけるはずだ。 \n
A2Q6SuccessfulFara	40 \n恐ろしい話ね。バールが史上最強の魔 \n道師の体を奪って、ディアブロと合流 \nしたなんて！　何とかして止めなけれ \nば。彼らはきっと、クラストの地下に \n封印された長兄、憎悪の王メフィスト \nを解放する気だわ。 \n  \n恐ろしい邪悪に立ち向かうあなたを、 \n信仰と光輝がお守りくださいますよう \nに。 \n
A2Q6SuccessfulGeglash	54 \nあんたぁスゲエな！　自分がちっぽけ \nに見えちまう... \n  \nいや、気にすんな。俺ら小者にも、手 \n柄を残しといてくれよな。 \n
A2Q6SuccessfulDrognan	51 \n実のところ、事態は深刻と言わざるを \n得ないね。特にタル・ラシャがバール \nに屈服したのは大きな痛手だ。ホラド \nリムの膨大な知識が、全てバールの手 \nに渡ったわけだからな。 \n  \n急いで海を渡ってクラストに行き、デ \nィアブロとバールがメフィストを解放 \nする前に止めてくれ。 \n  \nただ、東方の帝国はもはや昔の面影を \nとどめていないかもしれない。詳しい \n状況はわからないが。 \n  \nとにかく急ぐことだ。運命が君にほほ \nえむことを祈るよ。 \n
A2Q6SuccessfulMeshif	82 \n君を東の、クラストの街に連れていこ \nう。私も何年も帰っていないが、状況 \nはかなり悪いらしいな。 \n
A2Q6SuccessfulGreiz	51 \n敵を取り逃がしたって？　でもまあ、 \n魔王も怖じ気づくほどの力があるんだ \nって思えばいいじゃねえか。もう行く \nのかい？　そうか、ありがとうな。 \n
A2Q6SuccessfulCain	34 \nティラエルとは、260年前、ホラドリ \nムにソウルストーンを授けた大天使だ。 \n  \n  \n天界の者がこうまで深く地上の事件に \n介入するのは極めて異例だが、これは \nティラエルの独断だったのではないか \nと言われておる。 \n  \n彼ひとりが、我ら人類の能力に不安を \n抱いたか、それとも魔王の脅威を重く \n見たかして、天界の総意に背いたので \nあろうとな。 \n  \n地獄の活動目的はおおむね破壊に集約 \nされるが、天界の意図は計り知れぬ事 \nが多いものだ。 \n  \nさあ、急ごう。メフィストが解き放た \nれる前に、ディアブロとバールを止め \nねば。万が一にも三魔王がそろえば、 \nこの世界はもはや絶望だぞ。 \n
NatalyaIntroGossip1	40 \nこんにちは、勇者殿。武勲の噂は聞い \nているわ。三魔王を相手にしてこれほ \nどの活躍をするとは、大変なものね。 \n \n  \n私はナターリャ、邪悪を追う狩人。堕 \n落した魔道師を滅ぼすことを誓った、 \n古い教団の一員よ。 \n  \nできたら、あなたと一緒に魔王に立ち \n向かいたいけれど、知らせを待たなく \nてはいけないの。詳しくはわからない \nけれど、事態は予想以上に切迫してい \nるようね。 \n  \n上からの命令が来るまで、情報を提供 \nしてもいいわよ。 \n
NatalyaGossip1	74 \nアシェアラ？　あの荒っぽい女魔道師 \nね。でも、本物の魔神と戦った事はな \nさそうね。 \n  \nいくら酔いどれの傭兵魔道師を手なず \nけても、地獄の魔獣に立ち向かえると \nは限らないわ。 \n
NatalyaGossip2	66 \nデッカード・ケインの名はよく聞いて、 \n尊敬しているわ。ホラドリムの生き残 \nりだそうね。それほどの人物に選ばれ \nたなら、あなたもさぞ強いんでしょう \nね。 \n
NatalyaGossip3	100 \nフラトリは鍛冶の達人よ。彼の腕前は、 \n私の教団にも役立ちそうね。 \n
NatalyaGossip4	65 \n私の教団は、長い間オーマスを見張っ \nているわ。今は善の側についているよ \nうだけど、彼の魂にどんな影が潜んで \nいるかわからないもの。 \n
CainAct3IntroGossip1	40 \n栄光の街クラストからは、長らく遠ざ \nかっていたのだが...正直これほどの荒 \n廃とは思わなかったな。 \n  \nすべてメフィストの仕業に違いあるま \nい。頼むぞ友よ、ディアブロとバール \nを何としても阻まねば。 \n
CainAct3Gossip1	59 \n無惨に荒れた故郷を見て、メシフもさ \nぞ辛いだろうに。君のために街にとど \nまるとは、大したものだ。 \n
CainAct3Gossip2	79 \nアシェアラはずいぶん気の強い女性だ \nな。彼女のそばでは気を抜くな。 \n
CainAct3Gossip3	49 \nドログナンから、フラトリの噂は聞い \nている。鍛冶と魔法の両方に長け、神 \n秘の力を帯びた武器や防具を作るとか。 \n  \n  \n彼の技は大きな助けになるだろう。 \n
CainAct3Gossip4	39 \nあの独特の風体からすると、オーマス \nはいにしえのタアン魔道師族の者だろ \nう。誰も彼が魔道師とは気づいていな \nいようだが。 \n  \nタアンはかつてビジェレイにも匹敵す \nる力を誇ったが、実態は深い謎に包ま \nれている。彼は何を隠しておるのかな。 \n  \n
CainAct3Gossip5	44 \nナターリャに会ったか？　彼女はどう \nやら、クラル＝ハルツェクに属してお \nるようだ。ホラドリムに並ぶほどの歴 \n史をもった、秘密教団だよ。 \n  \nしかし、穏やかではないな。この教団 \nは、信頼に背いた魔道師を必ず追い詰 \nめ討ち取るとの誓いを立てておる。 \n  \nなぜここにいるのか... \n
CainAct3Gossip6	69 \nオーマスは狂気を装っているだけのよ \nうだ。言葉に惑わされず、行動を見よ。 \n  \n
HratliActIntroGossip1	28 \nクラストへようこそ、旅のお人。気は \n確かだろうね？　最近、自分からここ \nにくる奴は少ないが、正気の奴はもっ \nと少ないからな。 \n  \n俺はフラトリ、鍛冶の技を操る魔道師 \nさ。新しいお客は歓迎するよ。最近、 \n客がめっきり減ったものでね。 \n  \nいや見ての通り、メフィストのお陰で \n街の人口そのものが減った。堀割は血 \nで染まり、地上は魔獣だらけという有 \n様だ。 \n  \nクラストのほとんどは、不気味な密林 \nに呑まれてしまった。安全なのは、魔 \n法の防壁で守られたこの港の近辺だけ \nだが、ここもいつ緑の地獄に覆われる \nことやら。 \n  \nまた始末の悪いことに、ザカラム教徒 \nどもがメフィストの手下と結託してい \nる。連中は密林に覆われたクラストの \n奥地、寺院都市トラビンカルを根城に \nしているようだ。 \n  \nまあ、確かに奴らは信心深いが、「光 \n輝の戦士」も今では魔王の操り人形だ \nね。 \n
HratliActIntroSorGossip1	24 \nクラストへようこそ、若いソーサレス \nさん。気は確かだろうね？　最近、自 \n分からここにくる者は少ないが、正気 \nの者はもっと少ないからな。 \n  \n俺はフラトリ、鍛冶の技を操る魔道師 \nさ。新しいお客は歓迎するよ。最近、 \n客がめっきり減ったものでね。 \n  \nいや見ての通り、メフィストのお陰で \n街の人口そのものが減った。堀割は血 \nで染まり、地上は魔獣だらけという有 \n様だ。 \n  \nクラストのほとんどは、不気味な密林 \nに呑まれてしまった。安全なのは、魔 \n法の防壁で守られたこの港の近辺だけ \nだが、ここもいつ緑の地獄に覆われる \nことやら。 \n  \nまた始末の悪いことに、ザカラム教徒 \nどもがメフィストの手下と結託してい \nる。連中は密林に覆われたクラストの \n奥地、寺院都市トラビンカルを根城に \nしているようだ。 \n  \nまあ、確かに奴らは信心深いが、「光 \n輝の戦士」も今では魔王の操り人形だ \nね。 \n
HratliGossip1	44 \nこんな所に来るとは、いい度胸だな。 \n昔なら、大きな魔道師族に属していな \nい魔道師は、異端者として狩られたも \nのだが。まあ今では、魔道師族にそれ \nほどの権威はないがね。 \n
HratliGossip2	50 \n寺院都市の中には、大昔ホラドリムが \n建てた塔がある。これは一種の牢獄な \nんだが...まあ、いずれ嫌でも知ること \nになる。 \n
HratliGossip3	57 \n何だ、またザカラムの狂信者か？　お \n前らの売る物など何もいらんと言った \nだろう！ \n
HratliGossip4	71 \n俺の売り値は法外だと言われるが、俺 \nの腕が法外だから仕方ない。 \n
HratliGossip5	70 \nザカラム信者はゾンビーみたいにしつ \nこいが、ゾンビーほどのかわいげもな \nいね。 \n
HratliGossip6	66 \nアシェアラは「鉄狼団」という魔道師 \nの傭兵部隊を率いている。金を払えば \n何人かは雇えるが、大部分は港の警護 \nで忙しいよ。 \n
HratliGossip7	71 \nアルコーはポーション屋だ。研究道楽 \nで人生を浪費してきたような男さ。 \n
HratliGossip8	66 \nオーマスは謎だらけの奴だな。強い魔 \n力を感じるが、魔法の話は一度もしな \nい。 \n
HratliGossip9	44 \nメシフは知っているだろうが、あの男 \nがここの出身だという事も知っている \nか？ \n  \nクラストの惨状を見て、あの男も我々 \nと同様、おかしくなる寸前だろうよ。 \nみな血なまぐさい皮肉で、なんとか絶 \n望を防いでるのさ。 \n
HratliGossip10	61 \nあんたの連れのケインからも強い力を \n感じるが、魔法の気配はないな。ずい \nぶん不思議な男だ。 \n
HratliGossip11	44 \nナターリャは口の堅い女だな。何週間 \nもここにいるのに、何も明かさない。 \n何度か俺の武器を買いに来たから、戦 \n士か何かだろうとは思うが。 \n
MeshifAct3IntroGossip1	40 \nさあ、約束通り連れてきたぞ。 \n  \nしかしこんな事なら、私は二度と帰り \nたくなかった。この醜い密林が、美し \nいクラストのなれの果てだとは。 \n  \n敵が何者であれ、君が滅ぼしてくる事 \nを祈っているよ。私の故郷の痕跡が、 \n少しでも残っているうちにね。 \n
MeshifAct3IntroBarGossip1	39 \nバーバリアンの君なら、北方で厳しい \n景色もずいぶん見ただろうが... \n  \nしかしこんな事なら、私は二度と帰り \nたくなかった。この醜い密林が、美し \nいクラストのなれの果てだとは。 \n  \n敵が何者であれ、君が滅ぼしてくる事 \nを祈っているよ。私の故郷の痕跡が、 \n少しでも残っているうちにね。 \n  \nここで止めない限り、邪悪は君の故郷 \nをも覆い、いずれ全世界が三魔王に呑 \nまれてしまうだろう。 \n
MeshifAct3Gossip1	60 \n赤の他人の命と土地を守ってくれると \nは、素晴らしい勇気と義侠心だ。この \n災いが収まったら、街の皆でお礼をし \nたいものだね。 \n
MeshifAct3Gossip2	70 \nクラストのことなら任せておけ、など \nと言うのではなかったな。何もかも変 \nわってしまったよ。 \n
MeshifAct3Gossip3	99 \nクラストに残った「街」は、この港だ \nけか。 \n
MeshifAct3Gossip4	84 \n密林に分け入る気なら、アシェアラの \n鉄狼団から人手を雇った方がいいんじ \nゃないか？ \n
MeshifAct3Gossip5	73 \nケインは、危険の大きさをよく知って \nいるだろうに。それでも同行するんだ \nから、よほど君を信頼しているんだろ \nう。 \n
MeshifAct3Gossip6	78 \nここで常識があるのは、フラトリぐら \nいだよ。いや、まだ逃げないところを \n見ると、それも怪しいが。 \n
MeshifAct3Gossip7	78 \nアルコーに会いに行ったら、研究の邪 \n魔だと言われた。客が嫌いなんだな。 \n
MeshifAct3Gossip8	63 \nオーマスから情報を聞き出そうとする \nのは、岩から水を絞り出すようなもの \nだ。あの男の謎かけは、魔物のように \n厄介だよ。 \n
MeshifAct3Gossip9	72 \nあのナターリャという女性は、何かが \n起こるのを待っているようだね。変な \n人だ。 \n
MeshifAct3Gossip10	64 \n子供の頃のクラストは、風もかぐわし \nい楽園だった。今では汚物の悪臭しか \nしない。 \n
AshearaIntroGossip1	48 \nよう。こんな所に来るなんて、肝の据 \nわった冒険者だね。 \n  \nあたしはアシェアラだ。鉄狼団ってい \nう、魔道師部隊を束ねてる。何か月も \n前から密林の怪物を狩ってるんだけど、 \nいくら殺してもキリがないんだ。もう \nこの街は、すっかり魔物の手に落ちた \nも同然だね。 \n  \n噂だとあんた、この街を救いに来たそ \nうだね。だったら、うちの部下を雇わ \nせてやるよ。 \n  \nでも気をつけな。連中を怒らせたら、 \n森のバケモノより手に負えないから。 \n
AshearaIntroAmaGossip1	46 \nよう。あんたアマゾンだろ。噂は聞い \nてるよ。恐ろしく腕の立つ放浪の戦士 \nだって。 \n  \nあたしはアシェアラだ。鉄狼団ってい \nう、魔道師部隊を束ねてる。何か月も \n前から密林の怪物を狩ってるんだけど、 \nいくら殺してもキリがないんだ。もう \nこの街は、すっかり魔物の手に落ちた \nも同然だね。 \n  \n噂だとあんた、この街を救いに来たそ \nうだね。だったら、うちの部下を雇わ \nせてやるよ。 \n  \nでも気をつけな。連中を怒らせたら、 \n森のバケモノより手に負えないから。 \n
AshearaGossip1	62 \nあんたらの技は変わってるね。魔術だ \nけでも武術だけでもない、両方をうま \nく組み合わせて使うわけだろ。鉄狼団 \nの連中にも習わせてやりたいな。 \n
AshearaGossip2	160 \n人手があるのに、１人で戦う必要ない \nだろ？ \n
AshearaGossip3	103 \nいまどき、目的もなくクラストに来る \n奴はいない。あんたの目当ては名誉と \nカネだろ。 \n
AshearaGossip4	133 \nここじゃ、あたしら鉄狼団はよく稼い \nでる。 \n
AshearaGossip5	105 \n密林でうかうかしてると、すぐ敵に囲 \nまれるよ。せいぜい気をつけるこった。 \n  \n
AshearaGossip6	84 \nフラトリはちょっと、ゼニ勘定が得意 \nすぎるんだね。ま、腕はいいけど。 \n
AshearaGossip7	72 \nフラトリは冗談が好きらしい。こない \nだもあたしに、「女らしいのは顔の傷 \nだけだ」なんて言ってた。 \n
AshearaGossip8	94 \nメシフはここの出身だそうだけど、よ \nく帰ってくる気になったね。後悔した \nだろう。 \n
AshearaGossip9	74 \n鉄狼団に入らないかってナターリャを \n誘ったら、魔術の危険性とかについて \n散々説教されたよ。何様のつもりだっ \nてんだ。 \n
AlkorIntroGossip1	56 \n邪魔するなと何度言ったらわかるんだ、 \nこの馬鹿者... \n  \nああ、あんた新顔か。 \n  \n私はアルコー、錬金術師だ。ポーショ \nンや軟膏を扱っとる。必要なら売って \nやってもいい。 \n  \nだが気安く立ち寄るんじゃないぞ。研 \n究を邪魔されるのは好かんからな。 \n
AlkorIntroNecGossip1	43 \n邪魔するなと何度言ったらわかるんだ、 \nこの馬鹿者... \n  \nああ、あんたネクロマンサーか。死人 \nを起き上がらせ、霊魂を従えるほどの \n強い薬を使うそうだな。今度その調合 \nについて、話を聞かせてくれんかね。 \n \n  \n私はアルコー、錬金術師だ。ポーショ \nンや軟膏を扱っとる。必要なら売って \nやってもいい。 \n  \nま、いつでも寄ってくれよ。 \n
AlkorGossip1	52 \n研究漬けの私でも、密林の魔軍が勢い \nを増しているのはわかる。どうか生き \n残ってくれよ。あんたとはぜひ、死体 \n魔術に使う薬の成分について話し合い \nたいからな。 \n
AlkorGossip2	151 \n私の魔道書を見ていかんか？ \n
AlkorGossip3	90 \n私の薬を飲んだからって、不死身には \nなれんさ！　不死身かと思うほど健康 \nになれるだけだ。 \n
AlkorGossip4	100 \n私の蔵書は凄いぞ。異教学、解釈学、 \n書誌学に薬学と、何でもある。 \n
AlkorGossip5	50 \nThere was a very fat man here  \nrecently asking after the Golden  \nBird of Ku Y'Leh. Have you heard  \nof it? He kept muttering about  \nashes. I would imagine one Golden  \nBird's ash-hole to be about the  \nsame as another, wouldn't you? \n
AlkorGossip6	150 \n私は人間嫌いじゃない。馬鹿が嫌いな \nだけだ。 \n
AlkorGossip7	110 \nメシフと一緒に来たのか？　奴は馬鹿 \n専門の船長だぞ！ \n  \n生きてたどりつけて、よかったなあ。 \n
AlkorGossip8	93 \nアシェアラはいい客だよ。毎週、男気 \nのポーションを買ってくれる。 \n
AlkorGossip9	80 \nフラトリに作れるのは、変な魔法の武 \n器だけさ。自分のナイフもないんで、 \n石ころを持ち歩いて何にでも使っとる。 \n  \n
AlkorGossip10	88 \nオーマスはいつも謎かけばかりやっと \nるな。そうやって、頭がカラなのをご \nまかす気だろう。 \n
AlkorGossip11	48 \nナターリャはなかなか美人だな。特製 \nポーションを飲ませてやりたいよ。 \n  \nええと、「輝く美」じゃない、「太陽 \nの光」でもない... \n  \nこれだ、「凍った女を溶かす」。女っ \nぷりが上がるぞ。 \n
OrmusIntroGossip1	36 \n汝は今オーマスと話す。 \n  \nオーマスはかつて偉大な魔道師なりし \nが、今や沈みゆく船の鼠にも等しき身 \nなり。オーマスにまつわる謎は独り悩 \nむべし。汝の道に両極ありといえども、 \nそは勇者を志す者の常なり。 \n  \nオーマスに問わば英知を得るやもしれ \nず。オーマスに背を向けるならおのが \n心に答えを求めよ。 \n
OrmusIntroPalGossip1	37 \nパラディンよ、汝は今オーマスと話す。 \n  \n  \nオーマスはかつて偉大な魔道師なりし \nが、今や沈みゆく船の鼠にも等しき身 \nなり。オーマスにまつわる謎は独り悩 \nむべし。汝の道に両極ありといえども、 \nそは勇者を志す者の常なり。 \n  \nオーマスに問わば英知を得るやもしれ \nず。オーマスに背を向けるならおのが \n心に答えを求めよ。 \n
OrmusGossip1	54 \n汝の奉じる教会は今や悪に汚れたり。 \nしかしその教えと技は今も汝を救うべ \nし。 \n  \nオーマスは見る、この数奇なる時代を。 \n  \n
OrmusGossip2	62 \n汝の救いは「憎悪」を通してのみ得ら \nれん。信じがたき事なれど、真理なり。 \n  \n
OrmusGossip3	50 \n汝、いかにして「破壊」を壊す事がで \nきよう？　いかにして「恐怖」を怯え \nさせる事ができよう？　いと険しき道 \nなり。 \n
OrmusGossip4	70 \n今や光輝の教会は、最も深き闇を抱く。 \n汝、肝に銘ずべし。 \n
OrmusGossip5	85 \n死者を語る者は言の葉を忌むべしなり。 \n  \n
OrmusGossip6	82 \n知恵を用いず、まず捨てよ。さればト \nラビンカルへの道は開かれん。 \n
OrmusGossip7	92 \nアルコーのつむぐ言葉はオーマスより \nも解きやすし。 \n
OrmusGossip8	54 \n故郷を長く離れおりたるメシフ、今日 \nのクラストに胸を痛めること限りなし。 \n  \n
OrmusGossip9	90 \nアシェアラは誇りを抱き自らを信ず。 \n
OrmusGossip10	62 \nデッカード・ケイン。最後のホラドリ \nムに、オーマスは会わず。高慢がかの \n組織を滅ぼしたれば。 \n
OrmusGossip11	60 \nフラトリは疑う、オーマスは魔道師な \nらずや、と。疑うは彼の自由、オーマ \nスは真の魔術を見せず。 \n
A3Q4Init1CainAct3	49 \nメシフは、翡翠の小像が好きだと言っ \nていたな。航海中に変わった翡翠像を \n手に入れて、それと組になった品を集 \nめているそうだ。彼に見せてやっては \nどうかね。 \n
A3Q4Init1Asheara	160 \nケインが、翡翠像が何とか言ってたぜ。 \n  \n
A3Q4Init2MeshifAct3	50 \n素晴らしい！　これで、私の集めてい \nるセットがそろうよ！ \n  \nでは、この黄金の鳥の小像と交換しよ \nう。いい取り引きだろう。ありがとう。 \n  \n
A3Q4Init2Natalya	89 \n黄金の鳥を捜して、あっちこっち跳び \n回っているようね。大した勇者様だわ。 \n  \n
A3Q4Init3CainAct3	43 \nク・ユレという太古の賢者の伝説があ \nる。彼は死後の生命を研究していたそ \nうだ。私の記憶に間違いがなければ、 \n彼の遺灰は黄金の小像に納められたと \nいう。不思議な話だがね。 \n
A3Q4Init3Hratli	134 \nク・ユレの灰なら、アルコーに見せろ \nよ。 \n
A3Q4Init3Asheara	91 \nキレイな黄金像じゃないか。でもちゃ \nんと手入れしとけよ。中にびっちりホ \nコリが詰まってるぜ。 \n
A3Q4AfterInitAlkor	70 \nおお、ク・ユレの黄金の鳥か。これは \nすまんな。 \n  \nこの遺灰を使ってちょっと実験してみ \nたいから、しばらくしたらまた来てく \nれ。 \n
A3Q4AfterInitOrmus	48 \n永遠の若さを求めしク・ユレは、早き \n死のみを得たり。同じく不死を夢見る \n徒弟たちが彼を火葬せり、師の遺灰よ \nり魔力を得んとして。 \n
A3Q4AfterInitHratli	48 \nク・ユレといえば、不死のポーション \nを作ったって伝説もある大昔の賢者だ \nよ。ところが、飲んだ薬の効果が出る \n前に殺されたそうだ。皮肉なもんだな。 \n  \n
A3Q4AfterInitNatalya	78 \nあなたまで、死後の世界がどうこう言 \nうの？　死んだ後のことを心配する前 \nに、死なない努力をした方がいいんじ \nゃない？ \n
A3Q4SuccessfulAlkor	120 \nあんたのために、ク・ユレの遺灰から \n薬を作ったぞ。 \n
A3Q4SuccessfulMeshifAct3	94 \n不老不死なんて欲しくないね。 \n  \n何千年も、夜中に便所に起きるなんて \n考えたくもないよ。 \n
A3Q4SuccessfulCainAct3	60 \nそうか、黄金の鳥はメシフがずっと持 \nっていたか。彼はその値打ちを知らな \nかったと見えるな。 \n
A3Q4SuccessfulOrmus	51 \nオーマスは知る、ク・ユレの物語を。 \nかの賢者は、ひとつの真理を忘れたり。 \n生命は、ありのままに在るがゆえに尊 \nきもの。 \n  \nねじ曲げ引き延ばせば、生きた地獄に \n変じるなり。 \n
A3Q4SuccessfulNatalya	64 \n今までは正直、あなたのクエストなん \nて馬鹿にしていたけど、意味があるも \nのね。あなた、本当は頭がいいんだわ。 \n  \n
A3Q2InitCain	31 \n忘れてはいまいが、君がクラストに来 \nたそもそもの目標は、メフィストを滅 \nぼす事だ。古代ホラドリムはこの憎悪 \nの王を、クラストの中にある寺院都市 \nトラビンカルの「守りの塔」に封印し \nた。 \n  \nメフィストの牢獄に踏み込むには、「服 \n従の宝玉」と呼ばれる忌まわしき品を \n破壊せねばならない。 \n  \nそしてこの宝玉を砕くには、フレイル \nと呼ばれる竿状の武器が必要だ。それ \nも、彼に屈しなかったザカラム僧の魂 \nを宿した、太古のフレイルでなければ。 \n  \n  \n封印されたメフィストは、闇の魔力を \n使ってザカラムの高僧を汚染し、操っ \nた。しかし長老議会のケ＝ヘガンを務 \nめるカリムという者だけは、その術に \n染まらなかった。 \n  \nメフィストは操り人形となった長老議 \n会にカリムを殺害、破門させ、遺体を \n王国じゅうにばらまかせた。カリムの \n跡を継いでケ＝ヘガンとなったサンケ \nカーという僧は、メフィストに乗り移 \nられてしまった。 \n  \nこうして完全に魔王の手中に落ちた長 \n老議会は、「服従の宝玉」を使って教 \n会の組織を牛耳り、メフィストの存在 \nを人の眼から隠したのだ。 \n  \nまずは、カリムの遺体の部品を集めよ。 \n「心臓」と「脳」と「眼」だ。そして \nホラドリムのキューブを使い、それら \nをカリムのフレイルと合体させよ。 \n \n  \nその武器、「カリムの遺志」で「服従 \nの宝玉」を打ち砕いて初めて、メフィ \nストの隠れ家に挑むことができるのだ。 \n  \n
A3Q2EarlyReturnHeartCain	48 \nカリムの心臓を見つけたか。これは魔 \n王に抗う勇気を宿した品だ！ \n  \nこれを他のカリムの遺品、「眼」「脳」 \n「フレイル」とともにキューブに入れ \nるのだ。 \n
A3Q2EarlyReturnEyeCain	57 \nカリムの眼！　これは、メフィストへ \nの道を明かす品！ \n  \nこれを他のカリムの遺品、「心臓」 \n「脳」「フレイル」とともにキューブに \n入れるのだ。 \n
A3Q2EarlyReturnBrainCain	54 \nカリムの脳！　メフィストの弱点を知 \nっている品だ！ \n  \nこれを他のカリムの遺品、「眼」「心 \n臓」「フレイル」とともにキューブに \n入れるのだ。 \n
A3Q2EarlyReturnFlailCain	40 \nカリムの魔力を吹き込んで、このフレ \nイルで「服従の宝玉」を砕き、メフィ \nストの居場所を暴け。 \n  \nこれを他のカリムの遺品、「眼」「脳」 \n「心臓」とともにキューブに入れよ。 \nそうすれば求める武器、「カリムの遺 \n志」となる。 \n
A3Q2SuccessfulCain	50 \nよくやった、「カリムの遺志」が手に \n入ったぞ！　これを用いて「服従の宝 \n玉」を砕き、メフィストの居場所を暴 \nけ。 \n  \n真の光輝の導きを祈る。 \n
A3Q1InitAlkor	52 \n大事な研究時間を浪費したくないんで、 \n単刀直入に言うぞ。 \n  \nある貴重な本を探し出してもらいたい。 \nスカチムの大賢者ラム・エセンが、魔 \n王の及ぼす影響について書いた研究書 \nで、通称「黒き書」という。ただし、 \nスカチムがザカラムに敗れて以来、本 \nの行方は知れん。 \n  \nさあ急げ、ボヤボヤするな！　この本 \nが世界を救う鍵かもしれんのだ！ \n
A3Q1AfterInitAlkor	70 \n黒き書には、ザカラムに隠れて忘れ去 \nられた古代宗教スカチムの秘密が記さ \nれておる。 \n  \nだが、邪悪の者も黒き書を求めておる \nぞ。くれぐれも油断せぬようにな。 \n
A3Q1AfterInitOrmus	59 \nザカラムの子らは黒き書を、おぞまし \nき邪教の聖典と考えたり。なれど真実 \nは知る、かの書に世界を救う秘術が隠 \nされていることを。 \n
A3Q1AfterInitMeshifAct3	70 \n黒き書が実在するなんて、誰も信じて \nないよ。ザカラムがスカチムを弾圧す \nる口実として流した噂だろう。 \n
A3Q1AfterInitAsheara	100 \nクラストには何でもある。その本だっ \nてあるかもよ。 \n
A3Q1AfterInitHratli	50 \nラム・エセンの黒き書なら、俺達も捜 \nしたさ。ありかの噂は、疫病みたいに \n何度も流れた。もし見つけたら、アル \nコーに見せろよ。 \n
A3Q1AfterInitCainAct3	70 \n黒き書があれば、大いに役立つに違い \nない。しかし汚染されたザカラム教会 \nは、全力で君を討とうとするぞ。 \n
A3Q1AfterInitNatalya	80 \n黒き書の話なら聞いているわよ。私の \n教団も影響を受けているもの。もし見 \nつけられたら、尊敬するわね。 \n
A3Q1EarlyReturnAlkor	100 \n言わんかったか？　この書は魔王を破 \nる重要な手がかりになるんだぞ！ \n
A3Q1EarlyReturnOrmus	52 \n聖なる書を得た者は、言の葉の樹林に \n立ち向かうべし。その旅は剣の戦より \nも苦難に満ちたり。 \n
A3Q1EarlyReturnMeshifAct3	47 \n以前のクラストは世界最大の都市だっ \nた。今では街と森の境界さえ定かじゃ \nない。森は、流された同胞の血を吸っ \nて刻々と生い茂ってゆく。 \n
A3Q1EarlyReturnAsheara	63 \nあんたを信用するよ。 \n  \n実は最初は、ザカラムのスパイじゃな \nいかと疑ってたんだ。今のザカラム教 \n会本部は不思議な魔力に汚染されて、 \n悪の手先になってる。スカチムを弾圧 \nしたのも奴らだしね。 \n
A3Q1EarlyReturnHratli	59 \n情報が集まらない？ \n  \n人間なんて敷物と同じだ。どんなにキ \nレイに見えても、窓の外に吊して揺さ \nぶれば、驚くほどホコリが出てくるぞ。 \n  \n
A3Q1EarlyReturnCainAct3	79 \nクラストには寺院の廃墟があるそうだ \nぞ。黒き書は、そういう場所にあるの \nではないかな。 \n
A3Q1EarlyReturnNatalya	100 \n早く黒き書を見つけてよ。命令を待つ \n間、暇つぶしに読む物が欲しいんだか \nら。 \n
A3Q1SuccessfulAlkor	80 \n見つけたか、黒き書を！　これで魔王 \nの秘密がわかるに違いないぞ！ \n  \n君には読めまいが。 \n
A3Q1SuccessfulOrmus	68 \nラム・エセンの黒き書は、さながら棺 \nに似る。いずれも、人の未来の姿なれ \nば。 \n
A3Q1SuccessfulMeshifAct3	71 \nよかった、黒き書を見つけてくれたの \nか！　これで私の故郷を滅ぼした魔王 \nに復讐してやれるかもな！ \n
A3Q1SuccessfulAsheara	135 \n鉄狼団のみんなも感心してるよ。 \n
A3Q1SuccessfulHratli	71 \n本を見つけたか。後は、その内容に耐 \nえられるかどうかだ。 \n
A3Q1SuccessfulCainAct3	83 \nこの書に記された知識があれば、もう \nザカラムなど恐るるに足りんはずだ。 \n
A3Q1SuccessfulNatalya	86 \nへえ、本を見つけたの。驚いたわ。大 \nしたものね。 \n
A3Q3InitHratli	38 \n前にも言ったとおり、この港に魔物が \n入らないよう魔法の結界を張ってある \nんだが、最近その魔法が弱ってきたら \nしい。 \n  \n俺の覚えてる限り、この魔法を修復し \nて強化するには、スカチムの聖なる短 \n剣を使うしかない。ギドビンという名 \nだ。 \n  \n見つけてくれ。でないと俺達は終わり \nだ。 \n
A3Q3AfterInitAlkor	63 \nギドビンを知らんのか？　仕方がない、 \n教えてやるとしよう。 \n  \nギドビンは古代スカチム教団があがめ \nた聖遺物のひとつで、姿はダガー、つ \nまり短剣だ。 \n
A3Q3AfterInitOrmus	61 \nオーマスはギドビンをよく知る。なれ \nど汝のごとき異教徒が、スカチムの助 \nけを得られようか？ \n
A3Q3AfterInitMeshifAct3	62 \nギドビンといえば、古代宗教スカチム \nの数少ない遺品のひとつだ。強い魔力 \nがあるという話だが。 \n
A3Q3AfterInitAsheara	92 \nギドビンがあれば、港を守る結界は絶 \n対突破不可能になるだろうね。 \n
A3Q3AfterInitHratli	49 \n俺の知る限り、ギドビンはザカラム教 \n会の手に落ちたはずだ。もちろん、あ \nんたらにすんなり渡してはくれないだ \nろう。 \n  \nそれから信じられないだろうが、ギド \nビンを使えるのはオーマスだけだ。 \n
A3Q3AfterInitCainAct3	51 \nその後タアン族のことを調べてみたが、 \n彼らはどうやらスカチムの流れをくむ \n魔道師族らしい。 \n  \nとなれば、ギドビンを扱える者はオー \nマスしかおるまい。 \n
A3Q3AfterInitNatalya	70 \nギドビンは一見小さなダガーだけど、 \nスカチム魔道師が持てば絶大な魔力を \n発揮するそうよ。甘く見ないことね。 \n
A3Q3EarlyReturnAlkor	67 \n伝説によれば、スカチム僧は一本の短 \n剣に巨大な魔力を吹き込んだ。その力 \nがあれば、この港を狙う密林の魔物を \n追い出すなど造作もないはずだ。 \n
A3Q3EarlyReturnOrmus	80 \n影より平和を引き出すには、光輝を打 \nち砕く武器を得るべし。 \n
A3Q3EarlyReturnMeshifAct3	65 \nあれは密林なんてものじゃない。大地 \nの化膿だ。膿んでただれて、いきなり \n爆発したんだ。 \n
A3Q3EarlyReturnAsheara	145 \nギドビンはガッチリ守られてるだろう \nね。 \n
A3Q3EarlyReturnHratli	70 \nギドビンを見つければ、オーマスがそ \nいつを使って港の結界を修復してくれ \nる。 \n
A3Q3EarlyReturnCainAct3	72 \nギドビンはまだ見つからないかね。だ \nったら、もっと森の奥にあるのだろう \nかな。 \n
A3Q3EarlyReturnNatalya	94 \n早く探索に戻った方がいいわよ。魔物 \nはどんどん港に近づいてきているから。 \n  \n
A3Q3SuccessfulAlkor	75 \nほう！　ザカラムの鼻先から、ついに \n伝説の短剣を盗み出したか！　これは \n愉快だ！ \n
A3Q3SuccessfulOrmus	37 \n見事だ、高貴なる勇者よ。オーマスは \n汝を尊敬する。スカチムの古き精霊も、 \n聖遺物を救った汝を加護するであろう。 \n  \n  \nいま、オーマスは数年の空白を経て再 \nび魔術を用い、罪なき民を暗黒より守 \nる。港を囲む結界は、改めて力を得た \nり。 \n
A3Q3SuccessfulMeshifAct3	76 \nスカチムの精霊の力を借りて、街を荒 \nらした怪物どもに復讐してやりたいも \nのだ。 \n
A3Q3SuccessfulAsheara	96 \nこれで、港を警護する人数を減らせる。 \n鉄狼団の者が何人か、タダでもいいか \nらあんたの手助けがしたいって言って \nるぜ。 \n
A3Q3SuccessfulHratli	77 \nギドビンの魔力を使えるのはオーマス \nだけだ。 \n  \n奴のところに持っていけ。スカチム魔 \n術のことならよく知っているはずだ。 \n
A3Q3SuccessfulCainAct3	58 \n魔王と戦うにあたって古代宗教がこれ \nほどの役割を果たすとは、誰が予見し \nただろうか？　またしても見事な働き \nだったな。 \n
A3Q3SuccessfulNatalya	64 \nあなた本当に凄いわね。ザカラム教会 \nに立ち向かうなら手に入れておきたい \nと思ってた武器がいくつかあるけど、 \nギドビンもそのひとつよ。 \n
A3Q3RewardOrmus	101 \nこの魔法の指環は、我には不要。 \n  \n取るがよい、勇者よ！ \n
A3Q5InitOrmus	30 \n見事なり、わが友よ。汝の英知と胆力 \nは、われらを力づける。 \n  \nなれど今、汝は断つべし、地を覆う邪 \n悪の根元のひとつを。ザカラムの長老 \n議会を！ \n  \n太古、「守りの塔」に幽閉されし憎悪 \nの王メフィスト、当時のザカラム長老 \n議会に暗黒の魔力を及ぼせり。 \n  \nやがて世代を重ねるに従い、かつて高 \n潔なりし僧も忌まわしきメフィストの \n影に色濃く染まれり。今や長老議会に、 \nかつての美徳の片鱗もなし。 \n  \nメフィストは人心に潜む憎悪の芽をは \nぐくみ、敬虔な信者を残忍なる狂信者 \nに変えたり。汝、寺院都市トラビンカ \nルに分け入り、長老議会を討ち取るべ \nし。 \n  \n彼らが世を去れば、メフィストの力は \n大きく減じるものなれば！ \n
A3Q5AfterInitAlkor	81 \n「黒き書」には、今回のクエストのこ \nとも漠然と予言されているな。結果が \nどうなるかまでは読み解けないが。 \n
A3Q5AfterInitAlkorVA	87 \n私はただの、本好きなポーション屋だ \nぞ。トラビンカルの事など知るわけが \nなかろう。 \n
A3Q5AfterInitOrmus	50 \nホラドリムが寺院都市に「守りの塔」 \nを築いた目的はただひとつ、メフィス \nトを封印することなり。長老議会が滅 \nびれば、汝も塔に入れよう。 \n
A3Q5AfterInitOrmusVA	50 \nホラドリムが寺院都市に「守りの塔」 \nを築いた目的はただひとつ、メフィス \nトを封印することなり。長老議会が滅 \nびれば、汝も塔に入れよう。 \n
A3Q5AfterInitMeshifAct3	63 \n寺院都市へは、川をいくつも越えてい \nかなければならない。だが迷う心配は \nないよ。巨大な塔を目印にすればいい。 \n  \n
A3Q5AfterInitMeshifAct3VA	108 \nオーマスはどうも、無茶苦茶な話をす \nる時ほど言い回しが明確になるようだ。 \n  \n
A3Q5AfterInitAsheara	87 \n塔を守るザカラム教徒をいちいち相手 \nにしていたら、キリがないよ。さっさ \nと長老議会を仕留めないとダメざ。 \n
A3Q5AfterInitAshearaVA	100 \nザカラムの狂信者は、いくらでもいる \nからね。数で来られたら面倒だよ。 \n
A3Q5AfterInitHratli	100 \n傷ついたらいつでも帰ってくればいい \nさ。 \n
A3Q5AfterInitHratliVA	72 \nとんでもない時代だが、この災難もも \nう長くは続かないと思うね。 \n
A3Q5AfterInitCainAct3	60 \nオーマスの話によれば、長老議会の面 \n々はいずれも強い魔力を持っているら \nしい。となると話は厄介だぞ。 \n
A3Q5AfterInitCainAct3VA	90 \n寺院都市の警備はかなり厳重だ。頭を \n使うしかなかろうな。 \n
A3Q5AfterInitNatalya	100 \nライオンの檻に忍び込むなんて、本当 \nに勇敢ね。幸運を祈るわ。 \n
A3Q5AfterInitNatalyaVA	93 \nザカラム教徒には気をつけて。狂信者 \nは手に負えないわよ。 \n
A3Q5EarlyReturnAlkor	111 \nいいぞ、どんどん倒せ。残酷なものか。 \nいい気味だわい。 \n
A3Q5EarlyReturnAlkorVA	91 \n「黒き書」さえ見つかっておればなあ。 \nやはり悪の手が我々の邪魔をしておる \nのか。 \n
A3Q5EarlyReturnOrmus	45 \n汝の命、冒険に散らば、我は叙事詩を \n記さん。不死を得るにポーションは不 \n要なり、オーマスの言葉のみあれば。 \n
A3Q5EarlyReturnMeshifAct3	110 \n長老達は、寺院都市の中庭のあたりに \n住んでいるはずだ。 \n
A3Q5EarlyReturnMeshifAct3VA	107 \n魔王がここに、兄弟を捜しに来たとい \nう噂を聞いたぞ。 \n
A3Q5EarlyReturnAsheara	160 \nあたしも鉄狼団も、喜んで手を貸すよ。 \n  \n
A3Q5EarlyReturnAshearaVA	139 \n事態はどんどん差し迫ってくるね。 \n
A3Q5EarlyReturnHratli	62 \nザカラム教会じゃ、教義への絶対服従 \nが大原則だ。ちょっと異論を唱えただ \nけで、異端者として処刑された信者も \n多い。 \n  \nあんたを殺すぐらい平気さ。 \n
A3Q5EarlyReturnHratliVA	72 \n長年メフィストに仕えてきたんだから、 \n長老議会は憎悪と邪悪に染まりきって \nるだろう。 \n
A3Q5EarlyReturnCainAct3	80 \nサンケカーは「服従の宝玉」を使って \nザカラム教徒を操っておるのかもしれ \nん。 \n
A3Q5EarlyReturnNatalya	78 \n名誉のために危険に立ち向かう、あな \nたの勇気を尊敬するわ。成功の可能性 \nは低いけど...。 \n
A3Q5EarlyReturnNatalyaVA	78 \n名誉のために危険に立ち向かう、あな \nたの勇気を尊敬するわ。成功の可能性 \nは低いけど...。 \n
A3Q5SuccessfulAlkor	88 \nこれは奇跡だ！　長老議会さえ滅びれ \nば、もうザカラムに怯えなくてすむぞ！ \n  \n  \nありがとう！ \n
A3Q5SuccessfulOrmus	37 \nオーマスは汝に感謝する。汝の壮挙は \n暗く長いザカラムの暴虐を一掃し、三 \n魔王に大きな痛手を与えた。 \n  \nなれど、前途には真の試練が待つ。長 \n老議会が守り仕えてきた王は、いまだ \n黒き塔にあり。 \n
A3Q5SuccessfulMeshifAct3	75 \nもう、密林は枯れ始めたようだ。君が \n呪いを解いてくれたお陰だよ。光輝の \n恵みのあらんことを！ \n
A3Q5SuccessfulAsheara	125 \n光の宗教に、やっと真の陽が射したね。 \n  \n
A3Q5SuccessfulHratli	65 \nザカラム教徒は加減を知らないから手 \nを焼いていたんだが、これで少しはマ \nシになって欲しいもんだ。 \n
A3Q5SuccessfulCainAct3	44 \nザカラム長老議会の脅威は排除したが、 \n無論まだ終わりではない。次は「服従 \nの宝玉」を砕かねば。 \n  \n今も、ディアブロとバールがメフィス \nト救出に向け暗躍しておるだろう。油 \n断はできんぞ。 \n
A3Q5SuccessfulNatalya	85 \n信じられないわ。あなたの力が、オー \nラのように輝いて見える。 \n
A3Q6InitOrmus	50 \n今やディアブロとバールは寺院都市を \n探り当てたはず。彼らは、ホラドリム \nが「守りの塔」に封印せし長兄メフィ \nストを解放するすべを探っている。 \n  \n弟の魔王達に先んじよ。世界に憎悪を \n放たせてはならぬ。 \n
A3Q6AfterInitAlkor	90 \n塔の構造は、大昔に忘れ去られたが... \nしかし、地下深くまで上層と同じ造り \nという噂だ。 \n
A3Q6AfterInitAlkorVA	114 \nディアブロの姿は見たが、他の魔王の \n居所はわからん。 \n
A3Q6AfterInitOrmus	48 \n急ぐべし！　三魔王が再会を果たせば \n何をなすか、知る者はなし。 \n  \n心せよ、わが友よ、汝はいと強しとい \nえども、常人の力のみで魔王を滅ぼす \nことはかなわず。 \n
A3Q6AfterInitOrmusVA	48 \n急ぐべし！　三魔王が再会を果たせば \n何をなすか、知る者はなし。 \n  \n心せよ、わが友よ、汝はいと強しとい \nえども、常人の力のみで魔王を滅ぼす \nことはかなわず。 \n
A3Q6AfterInitMeshifAct3	62 \nまた塔に行くなら、気をつけてくれよ。 \nザカラム教徒の大部分は逃げたが、他 \nにどんな危険が待っているかも知れな \nい。 \n
A3Q6AfterInitMeshifAct3VA	116 \nうまく立ち回って、この呪いを永遠に \n終わらせてくれ！ \n
A3Q6AfterInitAsheara	52 \n鉄狼団から何人か送って、寺院都市の \n近くの密林を偵察させてたんだが...長 \n衣を着た２人の男に会った途端、とて \nつもない攻撃を受けたそうだ。 \n  \n部隊はほとんど全滅した。その２人は \nきっと、ディアブロとバールだ。 \n  \n急いだ方がいい。もう時間がないよ。 \n
A3Q6AfterInitAshearaVA	93 \nトラビンカルで、仲間が何人も死んで \nる。あそこじゃ悪の力が増すんだ。 \n
A3Q6AfterInitHratli	40 \nメフィストは元々、バールと同じ時に \nラット・ゴーレインの砂漠で捕獲され \nたんだが、魔王を２人も同じ場所に封 \n印するのは危険だった。 \n  \nそこでホラドリムがこのクラストに守 \nりの塔を建て、メフィストを幽閉した。 \nなのにザカラムは、塔のことなんかお \n構いなしに寺院都市を本拠にした。 \n \n  \nそれで自滅したのさ。 \n
A3Q6AfterInitHratliVA	68 \n近くクラストで再会する家族があるそ \nうだな。兄弟３人が手を取り合って。 \n
A3Q6AfterInitCainAct3	116 \n弟の魔王達より早くメフィストを見つ \nけねば。 \n
A3Q6AfterInitCainAct3VA	47 \nホラドリムはずっと、三魔王が封印を \n破り再会を果たすのを恐れてきた。そ \nの恐怖がまさか、最後である私の代に \n実現しそうになるとはな。 \n  \nこの破滅をくい止めることができるの \nは、君だけだ。決戦の時は近いぞ。 \n
A3Q6AfterInitNatalya	72 \nメフィストと戦うなら、憎悪の気持ち \nを抑えなさい。でないとそれこそ敵の \n思うつぼよ。 \n
A3Q6AfterInitNatalyaVA	73 \nメフィストと戦うなら、憎悪の気持ち \nを抑えなさい。でないとそれこそ敵の \n思うつぼよ。 \n
A3Q6EarlyReturnAlkor	63 \n嬉しい事に、ここまでの事件は全部ラ \nム・エセンの予言通りに進んでおる。 \nだが嬉しくない事に、予言は破滅で終 \nわる！ \n
A3Q6EarlyReturnAlkorVA	77 \nすまんが、答えられん。恐ろしさのあ \nまり、薬を飲みすぎた。 \n
A3Q6EarlyReturnOrmus	57 \nザカラムの大長老サンケカーこそ、今 \nのメフィストの「器」なり。 \n  \n恐怖と破壊が全てを覆う前に、憎悪に \nうち勝つべし。 \n
A3Q6EarlyReturnOrmusVA	75 \nもしディアブロとバールがメフィスト \nを放てばと、考えるもおぞましきなり。 \n  \n
A3Q6EarlyReturnMeshifAct3	110 \n出航の準備をしないと。いつここから \n逃げることになるかわからない。 \n
A3Q6EarlyReturnMeshifAct3VA	110 \n出航の準備をしないと。いつここから \n逃げることになるかわからない。 \n
A3Q6EarlyReturnAsheara	68 \n鉄狼団の仲間だって、何人もディアブ \nロ達にやられてるんだ。とむらい合戦 \nだよ！ \n
A3Q6EarlyReturnAshearaVA	200 \n死ぬまで戦うよ。 \n
A3Q6EarlyReturnHratli	66 \n魔神を地下に閉じこめるのに、なぜ塔 \nなど建てたんだろうな。ホラドリムに \nはどうも、常識がない。 \n
A3Q6EarlyReturnHratliVA	106 \n今ごろは塔の中を走り回ってないとい \nかんのじゃないか？ \n
A3Q6EarlyReturnCainAct3	93 \n塔の中をくまなく捜せ。メフィストは \n絶対中にいる。 \n
A3Q6EarlyReturnCainAct3VA	96 \n塔の中をくまなく捜せ。メフィストは \n絶対中にいる。 \n
A3Q6EarlyReturnNatalya	51 \n気をつけて。サンケカー自身も強大な \n魔力を持っている上に、何千もの狂信 \n者に取り巻かれているのよ。それにメ \nフィストの力が加われば、倒すのは簡 \n単じゃないわ。 \n
A3Q6EarlyReturnNatalyaVA	51 \n気をつけて。サンケカー自身も強大な \n魔力を持っている上に、何千もの狂信 \n者に取り巻かれているのよ。それにメ \nフィストの力が加われば、倒すのは簡 \n単じゃないわ。 \n
A3Q6SuccessfulAlkor	70 \n本当に素晴らしい。我々は救われたの \nか！　笑いたいが、顔が壊れそうだ。 \n
A3Q6SuccessfulOrmus	44 \n汝はついに、魔王を打ち倒せり。オー \nマスは感服し言葉もなし。なれどまだ、 \n戦いは終わらず。 \n  \n冥界の門を越え、ディアブロを完全に \n滅ぼすまでは。 \n
A3Q6SuccessfulMeshifAct3	67 \nこれでようやく、クラストの再建に取 \nりかかれる。本当にありがとう。 \n
A3Q6SuccessfulAsheara	62 \nお見事だね。あんたは本当に凄い戦士 \nだ。頼むから、鉄狼団の名誉団員にな \nってもらえないかい？ \n
A3Q6SuccessfulHratli	121 \n今から、文字通り地獄に向かうわけか。 \n  \n  \n吉報を待つよ。 \n
A3Q6SuccessfulCainAct3	38 \n君は、私が見込んだ以上の勇者だ。し \nかしディアブロは地獄に帰ったし、バ \nールも後に続いたに違いない。 \n  \n冥界の門に入り、恐怖の王を滅ぼして \nくれ。それ以外に、この世界を救う方 \n法はない！ \n
A3Q6SuccessfulNatalya	50 \nみんな、あなたがメフィストを倒した \nって話で持ちきりよ。私も一緒に地獄 \nに向かいたいけど、命令が来たわ。 \n  \n詳しくは言えないけど、北方のバーバ \nリアンの国に行かないと。さようなら、 \n幸運を祈るわ。また会いたいわね。 \n
TyraelActIntroGossip1	37 \nまた会えたな、勇者よ。 \n  \nいずれ来ると思っておったぞ。メフィ \nストの敗北は、光輝にとって大いなる \n朗報であった。ここなる「伏魔殿の砦」 \nは、燃えさかる地獄に築かれた天界軍 \n唯一の拠点である。 \n  \nこの地はあまたの光輝の戦士の命をも \nって築かれた。その多くは、そなたと \n同じ人間だ。魔王との決戦が迫ってお \nるが、その戦いに我が加勢することは \nできぬ。 \n  \n直接の参戦は禁じられておるのだ。許 \nされるのはわずかな助言のみ。これは、 \nそなたら人間の勝利でなければならぬ。 \n  \n  \n光輝がそなたを守り、天の光がそなた \nの道を照らさんことを。 \n
TyraelAct4Gossip1	54 \n太古、我はホラドリムとその末裔を見 \n守ると誓った身である。 \n  \nなれば、最後のホラドリムたるデッカ \nード・ケインを、このような異界で果 \nてさせる事はできぬ。 \n  \nそなたの友人ケインは我が守護する。 \n安堵せよ、勇者よ。 \n
CainAct4IntroGossip1	39 \n信じられるかね？　夢にでも考えた事 \nがあるかね？　天界と地獄界が交わる \n場所があるなどと！　この伏魔殿の砦 \nは、まさに奇跡と言うべき場所だよ！ \n \n  \nしかし無論、君の旅はまだ終わらない。 \nディアブロはこの地獄をのし歩き、魔 \n軍の再編を進めておるはず。彼を滅ぼ \nさぬ限り、世界の平和はない。 \n  \n急いでくれ。残された時間はわずかな \nのだ！ \n
CainAct4Gossip1	42 \n謎めいた大天使ティラエルの名は、文 \n献にたびたび現れる。人類の守り手と \nして、また強固な魂の象徴として、ホ \nラドリムは彼を崇敬した。 \n  \n彼はまた、天界の総意に背いてまで、 \n三魔王を封印するソウルストーンを当 \n時のホラドリムに与えたと言われてお \nる。 \n
HellsAngelGossip1	66 \n待て！　ディアブロの領地に入る前に、 \nメフィストのソウルストーンを砕くの \nだ！ \n  \n地獄の炉に行き、金床の上に石を置い \nて、あやまたず地獄の槌で打て。 \n
HellsAngelGossip2	63 \n勇者よ、恐怖の領国へ征くか。 \n  \nディアブロの本陣は５つの封印によっ \nて隠されておる。 \n  \nその封印をひとつずつ破らねば、恐怖 \nの王と戦うことはできぬぞ。 \n
A4Q1InitTyrael	37 \n聞け、この呪われた地に、ひとつの魂 \nが囚われ責めを受けておる。そなたら \n人類は、彼をイズアルと呼んだ。はる \nか昔には、我の忠実なる副官であった \n者だ。 \n  \nだが彼は血気にはやり、わが意に背い \nて地獄の炉に無謀な攻撃を仕掛けた。 \n \n  \nその勇猛と剛腕をもってしても勝利は \n得られず、魔王どもは彼を捕らえ、魔 \n力を用いて高潔なる魂をねじ曲げた。 \nその結果、彼は天界を裏切り重大な秘 \n密を明かしてしまったのだ。 \n  \n今の彼は、ありし日の痛ましき影でし \nかない。天界も地獄も信ずる事のでき \nぬ、みじめな堕天使だ。 \n  \nしかも大逆の報いとして、彼の魂は深 \n淵より召喚されし醜怪なる獣の肉体に \n移された。その拷問の檻の中で、彼は \nとうに正気を失い、しかしまだ苦悶を \n続けておる。 \n  \nそこで勇者よ、我はそなたに乞う。イ \nズアルの哀れな魂を、肉体の檻より解 \nき放ってくれぬか。 \n  \n彼はもう、充分に苦しんだであろう。 \n
A4Q1AfterInitTyrael	54 \nイズアルはもはや天使の魔剣「アズア \nラス」を持たぬが、今の体の腕力も決 \nして侮れぬ。 \n  \nそれに今の彼には、敵も味方もわから \nぬ事であろう。会えばたちどころに攻 \n撃を受けるものと心得えよ。 \n  \nくれぐれも用心するのだぞ。 \n
A4Q1AfterInitCain	50 \n堕天使イズアルと戦えと、ティラエル \nに頼まれたのか？　君は本当に高く買 \nわれたな！ \n  \n言うまでもあるまいが、気をつけてく \nれ。君は最後の希望なのだ。 \n
A4Q1EarlyReturnTyrael	70 \n躊躇はならぬ。早くイズアルを肉体よ \nり解放し、ディアブロに立ち向かうの \nだ。 \n  \nさあ、行け！ \n
A4Q1EarlyReturnCain	66 \n堕天使がなかなか見つからんか。 \n  \nだが急いでくれ。ここの空気にも、邪 \n悪の気配を感じるようになった。 \n
A4Q1SuccessfulIzual	47 \n我を信じるとは、ティラエル愚かなり！ \n  \n  \nかつて魔王どもにソウルストーンの秘 \n密を授け、汚染する手段を知らせたの \nは、他ならぬ我だ。その後彼らの地上 \n脱出を助け導いたのも、また我である \nのだぞ。 \n  \n精妙巧緻を極めたこの計画を、今さら \n人間ごときが阻もうとは、片腹痛いわ。 \n地獄は血と悪夢の巨大な津波と化し、 \n遠からず地上にあふれ出る定め！ \n  \nそなたら人類には、破滅あるのみ。 \n
A4Q1SuccessfulTyrael	48 \nすまぬ、よくぞイズアルの苦悶する魂 \nを救ってくれた。しかしそなたの話が \nまことであるならば、事態は重大であ \nるな。 \n  \nイズアルの入れ知恵で、魔王どもが進 \nんで我にソウルストーンを使わせたの \nなら、石はすでに汚染されていたとい \nう事だ。 \n  \n魔王ども自身の力に、汚れたソウルス \nトーンの力が加われば、地上界が地獄 \nに征服されるのは火を見るよりも明ら \nかであろう。 \n  \n光輝がそなたを守り、天の光がそなた \nの道を照らさんことを。 \n
A4Q1SuccessfulCain	64 \nよく生きていてくれた。すぐにもディ \nアブロを倒さねば！ \n  \nティラエルと相談したか？　彼の指示 \nを仰ぎ道を定めよ。 \n
A4Q3InitHasStoneCain	45 \nいよいよ、メフィストのソウルストー \nンを砕く時だ！ \n  \n石を持って地獄の炉に行き、金床の上 \nに置いて、あやまたず地獄の槌で打て。 \n  \n  \nメフィストが地上に出るのを永遠に防 \nぐには、それ以外にない。 \n
A4Q3InitNoStoneCain	42 \nいよいよ、メフィストのソウルストー \nンを砕く時だ！ \n  \n冥界の門に入る前、この石を取ったの \nは私だったが、砕くのは君の役目だろ \nう。 \n  \n石を持って地獄の炉に行き、金床の上 \nに置いて、あやまたず地獄の槌で打て。 \n  \n  \nメフィストが地上に出るのを永遠に防 \nぐには、それ以外にない。 \n
A4Q3SuccessfulCain	68 \nお見事だ、勇者殿！ \n  \n兄のソウルストーンが砕ける瞬間、か \nのディアブロといえども怒りに震えた \nだろうな。 \n
A4Q2InitTyrael	43 \nついに魔王ディアブロを追い、滅ぼす \nべき時が来た。 \n  \nなれど心せよ、恐怖の王は容易には屈 \nせぬ。かの者はかつてトリストラムの \n街をたやすく平らげ、彼を破った勇者 \nさえも堕落させた事を忘れるな。 \n  \n今度こそ確実に、永遠にディアブロを \n葬るのだ。そのためには、かの者の持 \nつソウルストーンを砕くしかない。 \n  \n武運を祈る。この最悪の闇が、そなた \nの勝利の栄光に照らされんことを。 \n
A4Q2AfterInitCain	50 \nこんな所をうろついている場合か！ \n  \n魔王が待っておるぞ。そして忘れるな、 \nディアブロの最大の武器は、恐怖だ。 \n  \n  \nおびえずひるまず、無心に立ち向かえ。 \n正義のために！ \n
A4Q2AfterInitTyrael	40 \nついに魔王ディアブロを追い、滅ぼす \nべき時が来た。 \n  \nなれど心せよ、恐怖の王は容易には屈 \nせぬ。かの者はかつてトリストラムの \n街をたやすく平らげ、彼を破った勇者 \nさえも堕落させた事を忘れるな。 \n  \n今度こそ確実に、永遠にディアブロを \n葬るのだ。そのためには、かの者の持 \nつソウルストーンを砕くしかない。 \n  \n武運を祈る。この最悪の闇が、そなた \nの勝利の栄光に照らされんことを。 \n
A4Q2SuccessfulTyrael	43 \n光輝を称えよ！　そなたは不可能を可 \n能にしたのだ！ディアブロとメフィス \nトは打ち砕かれ、そもそもの故郷であ \nる黒き深淵に還った。汚れしソウルス \nトーンももはやない。比類なき勇者よ、 \n今こそ喜び安らぐがよい。 \n
A4Q2SuccessfulCain	40 \n君ならやってくれると思っておったよ。 \nまったく信じがたい偉業だ。 \n  \n  \n私はホラドリムの先人と違い、研究の \nみに没頭してきたため戦場には立てな \nかったが、しかしその知識で君という \n勇者を補佐できたなら本望だ。さあ勇 \n者よ、この地を去ろう。この天界軍の \n砦は驚異ではあるが、しかしこの先ず \nっと、ここを訪れる必要がないことを \n切に願うね。 \n   \n   \n   \n
D2bnetHelp50	チャット　ヘルプ
D2bnetHelp	チャット　コマンド
D2bnetHelp2a	キャラクターを選択するには、各キャラクターの画像を左クリックして下さい。選択したキャラクターが金色のオーラで囲まれます。キャラクターの選択を解除するには、その画像を再び左クリックしてください。
D2bnetHelpa	画面左側、チャットウィンドウの下にあるボタンには、以下のような機能があります：
D2bnetHelp1	「送信」ボタンは、現在選択されているキャラクターに関係なく、チャットチャンネル内の全員にあててあなたのメッセージを配信します。このボタンは、テキストボックスに文字を入力すると使用可能になります。この「送信」機能は、メッセージ入力後にあなたのキーボードの「Enter」キーを押すだけでも代用できます。
D2bnetHelp2	「ささやき」ボタンは、選択したキャラクターだけにあなたのメッセージを送信します。このボタンは、テキストボックスに文字を入力して、他のキャラクターを選択すると使用可能になります。
D2bnetHelp3	「無視」ボタンは、選択したキャラクターからのメッセージ受信を停止します。無視されたキャラクターは、赤いX字形のオーラに包まれます。このボタンは、他のキャラクターを選択すると使用可能になります。
D2bnetHelp4	「無視解除」ボタンを押すと、「無視」されたキャラクターからのメッセージが再び表示されます。
D2bnetHelp5	「動作」ボタンを使うと、全員がテキストであなたの行動を「見る」ことができます。
D2bnetHelp5a	たとえば、DOOMHAMMERという名のキャラクターが、チャットチャンネルのプレイヤー全員に挨拶をしたい場合、<WAVES HELLO.(があいさつする)>と入力して「動作」ボタンをクリックすると、チャンネル内のプレイヤー全員が< DOOMHAMMER WAVES HELLO.(DOOMHAMMERがあいさつしています)>というメッセージを受信します。このボタンは、テキストボックスに文字を入力すると使用可能になります。
D2bnetHelp6	\dgrey;グレーの文字yc4は、誰かがチャットチャンネルに入室または退出したことを知らせます。
D2bnetHelp7	\tan;＜金色の文字＞yc4 は、発言者の名前を示します。
D2bnetHelp8	\grey;白い文字yc4 は、あなたや他のプレイヤーが全員に向けて「送信」した内容を示します。
D2bnetHelp9	\green;緑の文字yc4は、あなたがチャットチャンネルで誰かに「ささやき」した、もしくはされた内容を示します。
D2bnetHelp10	\blue;青い文字yc4は、チャンネル内のプレイヤーの「動作」や、直接battle.netから送信されてきた特別なメッセージを示します。
D2bnetHelp11	\red;赤い文字は、yc4 battle.netから直接送信されたエラーメッセージを表示します。
D2bnetHelp36	ダイアログ(対話)ウィンドウ
D2bnetHelp36a	画面右側にある、現在この文章が表示されているウィンドウは、ゲーム名やその情報やランキングなどを表示するのに使われます。チャットウィンドウと違い、このエリアの表示内容はあなたが選択した機能によって変わります。ボタン機能の詳細は、以下のとおりです：
D2bnetHelp37	 「新規作成」
D2bnetHelp37a	他のプレイヤーを迎えるための、新しいゲームを作成する機能です。その際に以下の内容を決める必要がありますが、オプション選択肢もあります。
D2bnetHelp38	 「ゲーム名」の欄には、他の人が「ゲーム参加」画面で見る、あなたのゲームの名前を入力します。無意味な名前でも説明的な名前でもかまいませんが、入力できる文字や名前などには制限があります。
D2bnetHelp39	作成するゲームを非公開にしたい場合、パスワードを設けて、それを知る特定のプレイヤーしか参加できないようにすることができます。
D2bnetHelp40	「ゲーム説明」の欄には、あなたが作成するゲームについての紹介文を書きます。自分のゲームにはこんなプレイヤーやキャラクターに参加してほしい、と募集する広告として使うといいでしょう。
D2bnetHelp41	 「最大プレイヤー数」を設定すると、一度に参加可能なプレイヤーの数を制限できます。基本設定は４人、最大で８人です。数字の横についている上下の矢印で、制限人数を調整することができます。
D2bnetHelp42	 「キャラクターレベル差」を使って、あなたに合わせて参加キャラクターのレベルを制限することができます。基本設定は「４」で、これはあなたより４レベル低い人から４レベル高い人までが参加できることを示します。数字の横についている上下の矢印で、制限レベル差を調整することができます。
D2bnetHelp42a	レベル制限を加えないようにするには、「キャラクターレベル差」の欄の左横にあるチェックボックスをクリックしてください。
D2bnetHelp43	 「Normal（ノーマル）」、「Nightmare（悪夢）」と「Hell（地獄）」は、ゲームの難易度を示します。最初はNormalに設定されています。NightmareやHellの難易度でゲームを開始するには、一定の条件があります。それを満たさないうちは、このオプションは選択できません。
D2bnetHelp44	参加
D2bnetHelp44ab	他の誰かが作成したゲームに加わることができます。この画面にリストアップされるゲームはすべて一般公開されていますから、プレイヤー数に余裕があればいつでも参加できます。
D2bnetHelp44a	このリストからゲームを選択すると、説明文や、キャラクターや、経過時間などの情報が表示されます。非公開のゲームに参加するには、そのゲームの名前とパスワードを入力する必要があります。
D2bnetHelp45	チャンネル
D2bnetHelp45b	すでにあるチャットチャンネルに参加するか、新規にチャンネルを作成することができます。すでにある公開チャンネルに参加するには、チャンネルリストからひとつ選んで「OK」ボタンをクリックしてください。非公開チャンネルに参加するには、希望するチャンネル名を入力してください。
D2bnetHelp45a	新規にチャンネルを作成したい場合は、「チャンネル名」の欄にそのチャンネルの名前を入力してください。このチャンネル名が今までに存在していないものでしたら、新しいチャンネルが自動的に作成されます。
D2bnetHel46	ランキング
D2bnetHelp46a	あなたの属するレルム（世界）での、ディアブロIIキャラクターランキングです。
D2bnetHelp47	 「標準ランキング」では、経験値順に上位キャラクターを見ることができます。基本設定はキャラクタークラスに関わりなく表示する「全体」ですが、「クラス別」のオプションを選択すれば、職業ごとのランキングも見られます。
D2bnetHelp48	 「ハードコア・ランキング」では、経験値順に上位のハードコア・キャラクターを見ることができます。基本設定はキャラクタークラスに関わりなく表示する「全体」ですが、「クラス別」のオプションを選択すれば、職業ごとのランキングも見られます。グレイの字は、そのキャラクターが死んでしまったことを示しています。
D2bnetHelp49	 「終了」のボタンを押せば、Battle.netチャットのインターフェイスを閉じてキャラクター選択画面に戻ります。Battle.netにはまだ接続していますが、キャラクターを選択するまではチャットもゲームもできません。
D2bnetHelp12	上級コマンド
D2bnetHelp12c	上級コマンドを使用するとき、相手を指定するにはbattle.netのアカウント名（account name）を使用しなければなりません。ディアブロIIのキャラクター名を使っても無効です。
D2bnetHelp12b	各キャラクターのアカウント名を調べるには、マウスのポインタをそのキャラクターの上にかざすか、キャラクターの画像を右クリックして「プレイヤー プロフィール」画面にアクセスしてください。また、自分のキャラクターを右クリックすれば、自分のプレイヤープロフィール画面を開いて内容を登録できます。
D2bnetHelp12a	普段メッセージを記入しているテキストボックスの先頭に以下のようなコマンドを入力すると、ボタンをクリックすることなく機能を使うことができます。各コマンドと、アカウント名やメッセージ本文の間には、必ずスペースをはさんでください。< >はこの例文で区切りを表しているだけなので、実際には入力しないでください。入力後、キーボードの「Enter」キーを押すと実行されます。入力を間違えると、普通の「送信」メッセージとして公開される場合があります。ご注意ください。
D2bnetHelp13	/WHISPER <アカウント名> <本文>, /W <アカウント名> <本文>
D2bnetHelp13b	/MSG <アカウント名> <本文>, /M <アカウント名> <本文>
D2bnetHelp13a	「ささやき」にあたるコマンドです。非公開メッセージをbattle.net内の特定ユーザーに送信します。
D2bnetHelp14	/ME <本文>, /EMOTE <本文> 
D2bnetHelp14a	「動作」に当たるコマンドです。あなたの動作を客観的に見せるときに使います。
D2bnetHelp15	/SQUELCH <アカウント名>
D2bnetHelp15b	/IGNORE <アカウント名>
D2bnetHelp15a	「無視」に当たるコマンドです。指定されたユーザーからのメッセージを無視します。
D2bnetHelp16	/UNSQUELCH <アカウント名>
D2bnetHelp16b	/UNIGNORE <アカウント名>
D2bnetHelp16a	「無視解除」にあたります。このユーザーからのメッセージ受信を再開します。
D2bnetHelp17	/AWAY <理由>
D2bnetHelp17a	メッセージを送信してくる人に、あなたがキーボードから離れていて、すぐには返信できないことを知らせてくれます。/AWAYコマンドの後には、必ず理由を明記してください。あなたに「ささやき」した人に、「<あなたのアカウント名> IS AWAY (理由).＝<あなたのアカウント名>は席を離れています(理由)」と自動的に返信されます。この自動メッセージを切るには、単に「/AWAY」のみ入力してください。
D2bnetHelp18	/DND
D2bnetHelp18a	「DO NOT DISTURB（邪魔しないでください）」の略。あなたに「ささやき」した人に、「<あなたのアカウント名> IS UNAVAILABLE (NOT AVAILABLE)＝<あなたのアカウント名>には連絡できません(連絡不能)」と自動的に返信されます。この自動メッセージを切るには、再び「/DND」と入力してください。
D2bnetHelp19	/CHANNEL <チャンネル名>, /JOIN <チャンネル名>
D2bnetHelp19a	お好きなbattle.netチャンネルに連れて行きます。テクニカル・サポートチャンネルにいくには、「/CHANNEL TECHNICAL SUPPORT」と入力するだけで結構です。存在しないチャンネル名を入力すると、その名前で新しいチャンネルが作成されてしまいます。
D2bnetHelp20	/WHO <チャンネル名>
D2bnetHelp20a	現在そのbattle.netチャンネルにいるプレイヤーのbattle.netアカウント名をリストアップします。
D2bnetHelp21	/BAN <アカウント名>
D2bnetHelp21a	特定のアカウント名の持ち主を、非公開チャンネルから追放（BAN）します。チャンネル管理者（そのチャンネルを開設した人か、先代管理者から指名され引き継がれたユーザー）のみが使用できます。強力で攻撃的なコマンドですから、慎重に使用してください。一度banされたアカウント名の持ち主を再びチャンネルに復帰させるには、「/UNBAN <アカウント名>」と入力してください。この措置をとらないかぎり、追放された人物はそのチャンネルに入れません。
D2bnetHelp22	 CTRL + c, CTRL + x, CTRL + v
D2bnetHelp22a	順にそれぞれ、選択したテキストを「コピー」、「切り取り」、「貼り付け」する操作です。テキストボックスに入力するのではなく、キーボードのキー２つを同時に押してください。フィールド内のテキストをすべて選択するには「CTRL + a」を使用してください。
D2bnetHelp23	/DESIGNATE <アカウント名>
D2bnetHelp23a	あなたがチャンネル管理者（そのチャンネルを開設した人か、先代管理者に指名され引き継がれた人）である時だけ使える機能です。別のプレイヤーを、次のチャンネル管理者として指定することができます。あなたがそのチャンネルを離れると、権限が引き継がれます。
D2bnetHelp24	/KICK <アカウント名>
D2bnetHelp24a	あなたがチャンネル管理者を務める時だけ使える機能です。非公開チャンネルから、特定のアカウント名の持ち主を一時的に追い出します。追い出されたプレイヤーは、すぐに復帰することができます。「/BAN」より軽い罰ですが、それでも相手を怒らせる危険があるのでご注意ください。
D2bnetHelp25	/REJOIN, /RESIGN
D2bnetHelp25a	現在参加中のチャンネルへ再入室します。この告知はチャンネル管理者が受け取ります。名前はリストの前方・一番上ではなく、最後・一番下に表示されます。
D2bnetHelp26	/WHOIS <アカウント名>, /WHERE <アカウント名>
D2bnetHelp26b	/WHEREIS <アカウント名>
D2bnetHelp26a	 Battle.net全公開チャットと全Blizzardゲーム内から活動中のプレイヤーを検索し、該当者があればそのアカウント名、アカウント番号、アカウント現在位置を表示します。
D2bnetHelp27	/WHOAMI
D2bnetHelp27a	あなたの現在のアカウント番号とbattle.netでの現在位置を知らせます。
D2bnetHelp28	/D2NOTIFY
D2bnetHelp28a	チャットチャンネル入室／退室の告知を切り替えます。このコマンドに対する自動返信の最後が「enabled」なら「可能になった」、「disabled」なら「不能になった」という意味です。
D2bnetHelp29	/HELP, /?
D2bnetHelp29a	 battle.net全般に共通のヘルプ文を、あなたのメッセージウィンドウに表示します（英語）。「/HELP <コマンド名など>」を入力すれば、特定の話題について調べることができます。
D2bnetHelp30	/TIME
D2bnetHelp30a	現在のBattle.netでの時刻と、あなたの現在地の時刻を表示します。
D2bnetHelp31	/USERS
D2bnetHelp31a	全Battle.net内で現在活動中のユーザー数、ゲーム数とチャンネル数を表示します。
D2bnetHelp32	/STATS <アカウント名> <プログラムID>
D2bnetHelp32a	 現在Battle.net内で展開しているBlizzard社の他のゲームの、ランキング統計などを表示します。各ゲームのプログラムIDは以下の通り。「StarCraft」は <STAR>、「Brood War」は<STARX>、そして「Warcraft II: battle.net Edition」は<W2BN>
D2bnetHelp33	自分のキャラクター画像を右クリックすると、自分のプレイヤープロフィールを登録できます。
D2bnetHelp34	 Battle.netチャットルームに入室中にTabキーを押すと、テキストボックスに、あなたが最近使った10種のコマンドが順に表示されます。
D2bnetHelp35	さらに不明な点がある場合は、日本時間の平日日中に「カプコンＰＣサポートセンター（052-760-0335）」にお電話いただくか、『ディアブロ２』日本語ホームページ( HTTP://WWW.CAPCOM.CO.JP/DIABLO2/ )をご参照いただくか、battle.netのTECHNICAL SUPPORTチャンネルにいってディアブロIIマニュアル（英語）をご覧になるか、Blizzard社テクニカルサポートページ( HTTP://WWW.BLIZZARD.COM/SUPPORT/ )にアクセスしてください（英語）。
D2bnetHelp51	BATTLE.NET コマンド一覧
D2bnetHelp52	/WHISPER
D2bnetHelp53	/ME
D2bnetHelp54	/AWAY
D2bnetHelp55	/SQUELCH, /UNSQUELCH
D2bnetHelp56	/BAN, /UNBAN, /KICK
D2bnetHelp57	/CHANNEL
D2bnetHelp58	/WHOIS, /WHERE, /WHOAMI
D2bnetHelp59	/D2NOTIFY
D2bnetHelp60	/DESIGNATE, /REJOIN
D2bnetHelp61	/TIME
D2bnetHelp62	/WHO, /USERS
D2bnetHelp63	/STATS
Moo Moo Farm	モーモー牧場
Chaos Sanctum	混沌の聖域
The Pandemonium Fortress	伏魔殿の砦
River of Flame	炎の河
Outer Steppes	さいはての草原
Plains of Despair	絶望の平原
City of the Damned	呪われし者の街
Durance of Hate Level 3	憎悪の牢獄 レベル3
Durance of Hate Level 2	憎悪の牢獄 レベル2
Durance of Hate Level 1	憎悪の牢獄 レベル1
Disused Reliquary	捨てられし宝物庫
Ruined Fane	神殿の廃墟
Forgotten Temple	忘れられし寺院
Forgotten Reliquary	忘れられし宝物庫
Disused Fane	捨てられし神殿
Ruined Temple	寺院の廃墟
Flayer Dungeon Level 3	フレイヤーのダンジョン レベル3
Flayer Dungeon Level 2	フレイヤーのダンジョン レベル2
Flayer Dungeon Level 1	フレイヤーのダンジョン レベル1
Swampy Pit Level 3	泥沼の穴 レベル3
Swampy Pit Level 2	泥沼の穴 レベル2
Swampy Pit Level 1	泥沼の穴 レベル1
Spider Cave	蟲の巣窟
Spider Cavern	蜘蛛の洞窟
Travincal	トラビンカル
Kurast Causeway	クラストの参道
Upper Kurast	クラスト北部
Kurast Bazaar	クラストの市場
Lower Kurast	クラスト南部
Flayer Jungle	フレイヤーの密林
Great Marsh	大湿地帯
Spider Forest	蜘蛛の森
Kurast Docktown	クラストの港
Durance of Hate	憎悪の牢獄
Flayer Dungeon	フレイヤーのダンジョン
Swampy Pit	泥沼の穴
Arcane Sanctuary	秘密の聖域
Duriel's Lair	タル・ラシャの墓室
Tal Rasha's Tomb	タル・ラシャの墓所
Ancient Tunnels	古代のトンネル
Maggot Lair Level 3	蛆虫の巣窟 レベル3
Maggot Lair Level 2	蛆虫の巣窟 レベル2
Maggot Lair Level 1	蛆虫の巣窟 レベル1
Claw Viper Temple Level 2	クロウ・ヴァイパーの寺院 レベル2
Halls of the Dead Level 3	亡者の回廊 レベル3
Stony Tomb Level 2	石の墓所 レベル2
Claw Viper Temple Level 1	クロウ・ヴァイパーの寺院 レベル1
Halls of the Dead Level 2	亡者の回廊 レベル2
Halls of the Dead Level 1	亡者の回廊 レベル1
Stony Tomb Level 1	石の墓所 レベル1
Palace Cellar Level 3	宮殿の貯蔵庫 レベル3
Palace Cellar Level 2	宮殿の貯蔵庫 レベル2
Palace Cellar Level 1 	宮殿の貯蔵庫 レベル1
Harem Level 2	ハーレム レベル2
Harem Level 1	ハーレム レベル1
Sewers Level 3	下水溝 レベル3
Sewers Level 2	下水溝 レベル2
Sewers Level 1	下水溝 レベル1
Canyon of the Magi	魔道師の渓谷
Valley of Snakes	蛇の谷
Lost City	失われた街
Far Oasis	はるかなるオアシス
Dry Hills	乾きの丘
Rocky Waste	岩の荒野
Lut Gholein	ラット・ゴーレイン
Maggot Lair	蛆虫の巣窟
Claw Viper Temple	クロウ・ヴァイパーの寺院
Halls of the Dead	亡者の回廊
Stony Tomb	石の墓所
Palace Cellar	宮殿の貯蔵庫
Harem	ハーレム
Sewers	下水溝
To The Moo Moo Farm	モーモー牧場へ
To Chaos Sanctum	混沌の聖域へ
To The River of Flame	炎の河へ
To The Outer Steppes	さいはての草原へ
To The Plains of Despair	絶望の平原へ
To The City of the Damned	呪われし者の街へ
To The Pandemonium Fortress	伏魔殿の砦へ
To The Durance of Hate Level 3	憎悪の牢獄 レベル3へ
To The Durance of Hate Level 2	憎悪の牢獄 レベル2へ
To The Durance of Hate Level 1	憎悪の牢獄 レベル1へ
To The Disused Reliquary	捨てられし宝物庫へ
To The Ruined Fane	神殿の廃墟へ
To The Forgotten Temple	忘れられし寺院へ
To The Forgotten Reliquary	忘れられし宝物庫へ
To The Disused Fane	捨てられし神殿へ
To The Ruined Temple	寺院の廃墟へ
To The Flayer Dungeon Level 1	フレイヤーのダンジョン レベル1へ
To The Flayer Dungeon Level 2	フレイヤーのダンジョン レベル2へ
To The Flayer Dungeon Level 3	フレイヤーのダンジョン レベル3へ
To The Swampy Pit Level 3	泥沼の穴 レベル3へ
To The Swampy Pit Level 2	泥沼の穴 レベル2へ
To The Swampy Pit Level 1	泥沼の穴 レベル1へ
To The Spider Cave	蟲の巣窟へ
To The Spider Cavern	蜘蛛の洞窟へ
To Travincal	トラビンカルへ
To The Kurast Causeway	クラストの参道へ
To Upper Kurast	クラスト北部へ
To The Kurast Bazaar	クラストの市場へ
To Lower Kurast	クラスト南部へ
To The Flayer Jungle	フレイヤーの密林へ
To The Great Marsh	大湿地帯へ
To The Spider Forest	蜘蛛の森へ
To The Kurast Docktown	クラストの港へ
To The Arcane Sanctuary	秘密の聖域へ
To Duriel's Lair	タル・ラシャの墓室へ
To Tal Rasha's Tomb	タル・ラシャの墓所へ
To The Ancient Tunnels	古代のトンネルへ
To The Maggot Lair Level 3	蛆虫の巣窟 レベル3へ
To The Maggot Lair Level 2	蛆虫の巣窟 レベル2へ
To The Maggot Lair Level 1	蛆虫の巣窟 レベル1へ
To The Claw Viper Temple Level 2	クロウ・ヴァイパーの寺院 レベル2へ
To The Halls of the Dead Level 3	亡者の回廊 レベル3へ
To The Stony Tomb Level 2	石の墓所 レベル2へ
To The Claw Viper Temple Level 1	クロウ・ヴァイパーの寺院 レベル1へ
To The Halls of the Dead Level 2	亡者の回廊 レベル2へ
To The Halls of the Dead Level 1	亡者の回廊 レベル1へ
To The Stony Tomb Level 1	石の墓所 レベル1へ
To The Palace Cellar Level 3	宮殿の貯蔵庫 レベル3へ
To The Palace Cellar Level 2	宮殿の貯蔵庫 レベル2へ
To The Palace Cellar Level 1 	宮殿の貯蔵庫 レベル1へ
To The Harem Level 2	ハーレム レベル2へ
To The Harem Level 1	ハーレム レベル1へ
To The Sewers Level 3	下水溝 レベル３へ
To The Sewers Level 2	下水溝 レベル２へ
To The Sewers Level 1	下水溝 レベル１へ
To The Canyon of the Magi	魔道師の渓谷へ
To The Valley of Snakes	蛇の谷へ
To The Lost City	失われた街へ
To The Far Oasis	はるかなるオアシスへ
To The Dry Hills	乾きの丘へ
To The Rocky Waste	岩の荒野へ
To Lut Gholein	ラット・ゴーレインへ
qstsa2q0	第二章　プロローグ
qstsa2q1	ラダメントの地下道
qstsa2q2	ホラドリムの杖
qstsa2q3	汚された太陽
qstsa2q4	秘密の聖域
qstsa2q5	召喚術師
qstsa2q6	七つの墓所
qstsa3q0	第三章　プロローグ
qstsa3q1	ラム・エセンの書
qstsa3q2	カリムの遺志
qstsa3q3	古代宗教の短剣
qstsa3q4	黄金の鳥
qstsa3q5	黒き寺院
qstsa3q6	守護者
qstsa4q0	第四章　プロローグ
qstsa4q1	堕ちた天使
qstsa4q2	恐怖の終焉
qstsa4q3	地獄の炉
qstsa2q01	ラット・ゴーレイン
qstsa2q11	ラット・ゴーレインの下水溝でラダメントの地下道を探せ。
qstsa2q12	ラダメントを殺せ。
qstsa2q13	アトマに会って報酬を受け取れ。
qstsa2q21	ラット・ゴーレインでケインに巻物を見せよ。
qstsa2q22	乾きの丘の亡者の回廊でキューブを 探せ。はるかなるオアシスを探って 蛆虫の巣窟で、杖の軸を取れ。クロ ウ・ヴァイパーの寺院へ踏み込んで 杖の頭部を探せ。
qstsa2q23	ホラドリムのキューブを使って杖を 再生せよ。
qstsa2q24	杖をタル・ラシャの墓所に持ってゆけ。
qstsa2q25	発掘品をラット・ゴーレインのケイ ンに見せよ。
qstsa2q31	暗闇を生んだ源を探せ。
qstsa2q31a	謎の暗闇についてドログナンに尋ねよ。
qstsa2q32	失われた街の彼方にある蛇の谷でクロウ・ヴァイパーの寺院を探索して大蛇の祭壇を破壊せよ。
qstsa2q33	ラット・ゴーレインの市民に話し掛けよ。
qstsa2q41	宮殿の底の秘密の聖域を探し出せ。
qstsa2q41a	ドログナンに話しかけよ。
qstsa2q42	ホラゾンの日誌を探せ。
qstsa2q43	第七の墓所の探索を続けよ。
qstsa2q51	召喚術師には用心せよ。
qstsa2q52	召喚術師を討ち取れ。
qstsa2q53	街に戻って情報を集めよ。
qstsa2q61	タル・ラシャの墓所を探せ。
qstsa2q61a	これが真のタル・ラシャの 墓所の紋章である。
qstsa2q62	ドゥリエルを討ち取れ。
qstsa2q63	タル・ラシャの墓室を探索せよ。
qstsa2q63a	ジェリンに話しかけよ。
qstsa2q64	ジェリンに話しかけよ。
qstsa2q65	メシフに話しかけよ。
qstsa3q01	密林の村
qstsa3q11	市場、クラスト北部、参道に建つ六つの寺院を調べて、ラム・ エセンの書を探せ。
qstsa3q12	アルコーに話しかけよ。
qstsa3q21	カリムの遺品を探索せよ。まず蜘蛛 の洞窟で彼の「眼」を取れ。
qstsa3q22	フレイヤーのダンジョンにてカリムの「脳」を探し出せ。
qstsa3q23	寺院都市トラビンカルに行ってカリムのフレイルを入手せよ。長老議会に用心せよ。
qstsa3q24	クラストの市場の下水溝でカリムの「心臓」を手に入れよ。
qstsa3q25	ホラドリムのキューブでカリムの 遺品（フレイル、眼、心臓、脳）を合成 せよ。
qstsa3q26	カリムの遺志で、服従の宝玉を破壊せよ。
qstsa3q21a	カリムの遺品について、ケインにたずねよ。
qstsa3q31	フレイヤーの密林にて、短剣ギドビンを探せ。
qstsa3q32	ギドビンを取れ。
qstsa3q33	ギドビンをオーマスに渡せ。
qstsa3q34	アシェアラに話しかけよ。
qstsa3q35	オーマスに話しかけよ。
qstsa3q41	翡翠の小像について、ケインに聞け。
qstsa3q42	メシフに翡翠の小像を見せよ。
qstsa3q43	ケインに、黄金の鳥のことを聞け。
qstsa3q44	黄金の鳥を、アルコーに渡せ。
qstsa3q45	アルコーに会って、報酬を受け取れ。
qstsa3q51	トラビンカルの黒き寺院を探せ。
qstsa3q52	長老議会の面々を討ち取れ。
qstsa3q53	ケインに助力を頼め。
qstsa3q61	カリムの遺志で服従の宝玉を破壊し、メフィストの牢獄への道を開け。
qstsa3q62	牢獄を探索しメフィストを発見せよ。
qstsa3q63	メフィストを討ち取れ。
qstsa3q31a	港で、ギドビンについて尋ねよ。
qstsa3q51a	オーマスに、黒き寺院について聞け。
qstsa3q61a	オーマスが、守護者について知っている。
qstsa4q11	絶望の平原にて、イズアルを探せ。
qstsa4q12	イズアルの魂を捕らえている魔物を退治せよ。
qstsa4q13a	イズアルの霊に話しかけよ。
qstsa4q13	ティラエルに会って報酬を受け取れ。
qstsa4q31	メフィストのソウルストーンを、地獄の炉に持ってゆけ。
qstsa4q32	メフィストのソウルストーンを、地獄の炉で破壊せよ。
qstsa4q33	炉で、地獄の槌を使え。
qstsa4q34	ケインに相談せよ。
qstsa4q21	混沌の聖域で、五つの封印を解け。
qstsa4q22	ディアブロを討ち取れ。
qstsa4q23	残る%d個の封印を解け。
qstsa4q24	最後の封印を解け。
asheara	アシェアラ
hratli	フラトリ
alkor	アルコー
ormus	オーマス
nikita	ナターリャ
tyrael	ティラエル
Izual	イズアル
izual	イズアル
Jamella	ジャメラ
halbu	ハルブ
Malachai	ハドリエル
merca201	ハザデ
merca202	アルヒジル
merca203	アズラエル
merca204	アーサブ
merca205	チャーラン
merca206	ハシーン
merca207	ラザン
merca208	エミリオ
merca209	プラザム
merca210	ファゼル
merca211	ジェマリ
merca212	カシム
merca213	グルザール
merca214	ミザン
merca215	レハラス
merca216	ダーガ
merca217	ニーラジ
merca218	イルザン
merca219	ザナリー
merca220	ワヒード
merca221	ヴィキャト
merca222	ジェラニ
merca223	バラニ
merca224	ジャバリ
merca225	デヴァック
merca226	ラーディン
merca227	テラッシュ
merca228	アジヒード
merca229	ナルフェト
merca230	カリール
merca231	ファエット
merca232	ゲシェフ
merca233	ヴァンジ
merca234	ハフェット
merca235	タダール
merca236	ヤティラジ
merca237	ラッジ
merca238	ヤシード
merca239	ラーハッド
merca240	フラックス
merca241	スコーチ
qf1	カリムのフレイル
qf2	カリムの遺志
KhalimFlail	カリムのフレイル
SuperKhalimFlail	カリムの遺志
qey	カリムの眼
qbr	カリムの脳
qhr	カリムの心臓
The Feature Creep	武具師へファスト
Hell Bovine	地獄の牛
Playersubtitles00	不可能だ。
Playersubtitles01	無理だ。
Playersubtitles02	加勢を！
Playersubtitles03	加勢を！
Playersubtitles04	こっちへ！
Playersubtitles05	さあ！
Playersubtitles06	あげよう。
Playersubtitles07	あげよう。
Playersubtitles09	ありがとう。
Playersubtitles10	どうも。
Playersubtitles11	おっと
Playersubtitles12	失礼。
Playersubtitles13	さようなら。
Playersubtitles14	じゃ。
Playersubtitles15	死ね！
Playersubtitles16	さあ死ね！
Playersubtitles17	マナが足りない。
Playersubtitles18	マナが足りない。
Playersubtitles21	まだ使いこなせない。
Playersubtitles22	荷物が多すぎる。
Playersubtitles23	もう持てない。
Playersubtitles24	街ではだめだ。
Playersubtitles25	ここではだめだ。
Playersubtitles26	ここで術は使えん。
Playersubtitles27	鍵がない。
Playersubtitles28	鍵がない。
LeaveCampAma	さ、悪魔の大掃除だ。
LeaveCampBar	魔物め、見てろ。
LeaveCampPal	この地を清めてくれる。
LeaveCampSor	行くわよ！
LeaveCampNec	やってやろうか。
EnterDOEAma	魔物の声がするよ。
EnterDOEBar	敵が山ほどいる。
EnterDOEPal	悪がはびこっておる。
EnterDOESor	危険そうね。
EnterDOENec	死の気配を感じる。
EnterBurialAma	哀しみが漂ってるね。
EnterBurialBar	死神に会えそうだ。
EnterBurialPal	神聖な地が汚されておる！
EnterBurialSor	闇の魔術が使われているわね。
EnterBurialNec	空の墓穴が多すぎるな。
EnterMonasteryAma	ここがアンダリエルの本拠だね。
EnterMonasteryBar	この修道院、魔物くさいな。
EnterMonasteryPal	この闇には光も射さぬか。
EnterMonasterySor	ここが修道院...アンダリエルの砦ね！
EnterMonasteryNec	魔神の悪臭がこもっている。
EnterForgottenTAma	何のにおい？
EnterForgottenTBar	毒のにおいだ･･･。
EnterForgottenTPal	邪悪をはらってくれよう。
EnterForgottenTSor	ここには秘密が隠されているわ。
EnterForgottenTNec	死の気配が漂っている。
EnterJailAma	ひどい拷問の跡だね。
EnterJailBar	檻は好かんな。
EnterJailPal	戦士の死すべき地ではない。
EnterJailSor	魔術が使われたとしても昔の話ね。
EnterJailNec	ここで飢え死にさせるわけか。
Barracksremoved	削除
Barracksremoved	削除
Barracksremoved	削除
Barracksremoved	削除
Barracksremoved	削除
EnterCatacombsAma	気味が悪いね。
EnterCatacombsBar	湿って寒い場所だ。
EnterCatacombsPal	ここには悪がおるぞ。
EnterCatacombsSor	骨まで冷えそう。
EnterCatacombsNec	魔物の存在を感じる。
CompletingDOEAma	これでシスターに信用してもらえそうだね。
CompletingDOEBar	しばらくはローグ族も安心だ。
CompletingDOEPal	この地での務めは終わった。
CompletingDOESor	この洞窟の魔物は滅んだわ。
CompletingDOENec	これでローグ族に信用されるかな。
CompletingBurialAma	安らかに、シスター。
CompletingBurialBar	成仏しな、ブラッド・レイヴン。
CompletingBurialPal	許せ、仕方なかった。
CompletingBurialSor	おやすみ、ブラッド・レイヴン。
CompletingBurialNec	ブラッド・レイヴン、安らかに。
FindingInifusAma	変な木だね...
FindingInifusBar	変わった木だ。
FindingInifusPal	この木は魔術で輝いておる！
FindingInifusSor	この古い木は魔法のオーラをまとっている。
FindingInifusNec	この木は魂を宿している。
FindingCairnAma	この石、魔術の道具だね。
FindingCairnBar	この魔法の石はかなり古いな。
FindingCairnPal	アカラならばこの石の謎が解けようか？
FindingCairnSor	この石は魔力を放射してるわね。
FindingCairnNec	石の周囲に霊気を感じる。
FindingTristramAma	激戦の跡だね。
FindingTristramBar	死に絶えた土地だ。
FindingTristramPal	トリストラムが...何と無惨な！
FindingTristramSor	この街も、ディアブロにはかなわなかったのね。
FindingTristramNec	かつて栄えたトリストラムも灰燼に帰したか。
RescueCainAma	ケイン、すぐローグ族のキャンプへ！
RescueCainBar	ケイン、すぐここを出ろ！
RescueCainPal	デッカード・ケイン、すぐ発つのだ！
RescueCainSor	ケイン、ローグ族のキャンプへ！
RescueCainNec	デッカード・ケイン、命が惜しいならすぐ逃げろ。
HoradricMalusAma	これを取り戻せば教団のみんなが喜ぶね！
HoradricMalusBar	これをチャルシに持っていこう。
HoradricMalusPal	これで教団も魔神に立ち向かえよう。
HoradricMalusSor	みんなが喜ぶといいけど...
HoradricMalusNec	大騒ぎの末に、ハンマー一丁か？
CompletingForgottenTAma	塔のお宝、もらったよ！
CompletingForgottenTBar	すごい獲物だ！
CompletingForgottenTPal	勝利の権利により、この宝をもらい受ける。
CompletingForgottenTSor	こんな宝がもっとあるといいわね！
CompletingForgottenTNec	宝捜しも悪くない、か。
CompletingAndarielAma	これでもう、苦しみを広めることもないね！
CompletingAndarielBar	これで門が開く！
CompletingAndarielPal	この地での務めは終わった。
CompletingAndarielSor	悪の女王の最期ね。
CompletingAndarielNec	地獄へ帰るんだな、アンダリエル。
EnteringRadamentAma	吐き気がするわ。
EnteringRadamentBar	死臭だ...間違いなく人間の。
EnteringRadamentPal	邪悪の臭気が立ちこめておる。
EnteringRadamentSor	魔術の気配だわ。
EnteringRadamentNec	強力なアンデッドの力を感じる...
CompletingRadamentAma	アトマ、恨みは晴らしたよ。
CompletingRadamentBar	これで仕事も一段落か。
CompletingRadamentPal	これでアトマも安らげよう。
CompletingRadamentSor	哀れな怪物ね。
CompletingRadamentNec	貴重な遺体の浪費だな。
BeginTaintedSunAma	次は日蝕か。よくもまあ次々と。
BeginTaintedSunBar	太陽に何が起こった？
BeginTaintedSunPal	悪魔が陽の光をも汚したか？
BeginTaintedSunSor	日蝕を起こすなんて、信じられない術だわ。
BeginTaintedSunNec	太陽を隠すとは、恐ろしい魔法だ。
EnteringClawViperAma	結構ヤバい感じだね。
EnteringClawViperBar	この地に太陽は輝かないのか！
EnteringClawViperPal	天なる光よ、闇を行く我を導きたまえ。
EnteringClawViperSor	かなり強大な魔力ね。
EnteringClawViperNec	墳墓のごとき暗さだ。
CompletingTaintedSunAma	光あれ、ね。
CompletingTaintedSunBar	太陽を呼び戻せて何よりだ。
CompletingTaintedSunPal	光輝の力は決して邪悪には屈せぬのだ。
CompletingTaintedSunSor	こんな下等動物が、こんな大事件を起こしたなんて！
CompletingTaintedSunNec	残念だな。闇の時間がもう終わりとは。
EnteringArcaneAma	この秘密を見つけたのは、あたしが最初？
EnteringArcaneBar	迷いそうな場所だな。
EnteringArcanePal	なんと歪んだ魂の産物であろうか！
EnteringArcaneSor	本当に、自然法則が歪んでいる...素敵だわ。
EnteringArcaneNec	素晴らしい。できればこの異次元を研究したいものだ。
FindingSummonerAma	何なんだよ、こいつ？
FindingSummonerBar	消えろ。バカの寝言につき合う暇はない。
FindingSummonerPal	邪悪に魂を汚され正気を失うたか。
FindingSummonerSor	あれがホラゾンなの？
FindingSummonerNec	まさか、あれが偉大なるホラゾンではあるまいな！
CompletingSummonerAma	いい気味だわ。
CompletingSummonerBar	腐った魔道師の血で手を汚すのは、やりきれん。
CompletingSummonerPal	さいなまれし魂よ、安らかに。
CompletingSummonerSor	あれがホラゾンのはずはないわ。哀れな。
CompletingSummonerNec	奴はホラゾンではない。たまたま力を持っただけの、愚か者だ！
FindingdecoyTombAma	きっとここだね。
FindingdecoyTombBar	かなり凝った細工だな。これがタル・ラシャの墓か。
FindingdecoyTombPal	これが求める墓所か？
FindingdecoyTombSor	ホラドリムの紋章があるわ。これがタル・ラシャの墓所？
FindingdecoyTombNec	これがタル・ラシャの墓所だろうか？　異様な力を感じるが。
FindingTrueTombAma	ここなの？　魔王の罠がありそうだね。
FindingTrueTombBar	風が冷たい...きっと本物の墓だ。
FindingTrueTombPal	ようやく見つけた、偉人を葬るにふさわしい墓碑銘を。
FindingTrueTombSor	これが本当の墓所に違いないわ！
FindingTrueTombNec	凄まじいオーラを感じる。かなり強力な存在が隠されているのは間違いない。
CompletingTombAma	うまくないね。いつまで続くんだろう？
CompletingTombBar	ディアブロはバールを逃がした後か。まだまだ安心はできんわけだ。
CompletingTombPal	魔王を残らず滅ぼし、タル・ラシャの遺志に報いてくれよう。
CompletingTombSor	ディアブロもバールも逃げたのね！　今に見てなさい！
CompletingTombNec	遅かった。恐怖に加え破壊の魔王までが地上に出たか。
nodarkwanderer	ゲームに参加していません。
FindingLamEsenAma	この本が役に立ってくれればいいんだけどね。
FindingLamEsenBar	苦労に見合う値打ちがあればいいが。
FindingLamEsenPal	黒き書...ザカラム長老議会にとっては禁断の異端書か。
FindingLamEsenSor	内容に合わせて、本そのものも重いわね。
FindingLamEsenNec	この本からは、不思議な力を感じる！
CompletingLamEsenAma	この本のために、ずいぶん苦労したんだよ。
CompletingLamEsenBar	これでクラストの影が晴れればいいが。
CompletingLamEsenPal	これが邪悪を払う力とならんことを！
CompletingLamEsenSor	これで魔王を滅ぼすことができるかも！
CompletingLamEsenNec	期待通りの内容なら、多くの秘密が明かされるはずだ。
FindingBeneathCityAma	ううっ...いったい何の死臭だい？
FindingBeneathCityBar	息が詰まりそうなにおいだ！
FindingBeneathCityPal	死臭...いや、もっと邪悪な臭気だ。
FindingBeneathCitySor	傷んだ薬よりもひどい悪臭ね。
FindingBeneathCityNec	また下水に潜ることになるとはな。
FindingDrainLeverAma	これで何とかなるといいけど。
FindingDrainLeverBar	これで汚水が流せそうだ。
FindingDrainLeverPal	これで古代の水栓を操作するようだな。
FindingDrainLeverSor	これみたいね。
FindingDrainLeverNec	これが目当てのレバーらしい。
CompletingBeneathCityAma	やった！
CompletingBeneathCityBar	助かった。これでやっと、地上の空気が吸える。
CompletingBeneathCityPal	これでクラストにかかった呪いも解ける！
CompletingBeneathCitySor	これで魔神との戦いが楽になるといいわね。
CompletingBeneathCityNec	ふん、下水にふさわしいガラクタだな。
CompletingBladeAma	これで港を魔物から守れるんだね。
CompletingBladeBar	この聖剣は、ザカラムが持つべきじゃない。
CompletingBladePal	この刃で邪悪の心臓を貫く！
CompletingBladeSor	これをオーマスに届けるのね。
CompletingBladeNec	強い力を持つ品だ。オーマスから詳しい話を聞きたいものだな。
FindingJadeFigAma	誰か買ってくれるかな？
FindingJadeFigBar	変わった小像だ。
FindingJadeFigPal	何かもっと、有益な品と交換できるだろうか？
FindingJadeFigSor	妙ね。魔法の気配は何もないわ。
FindingJadeFigNec	つまらん像だ。交換用ぐらいには使えそうだが。
FindingTempleAma	光輝の教会にしちゃ、ずいぶん暗いね...。
FindingTempleBar	天地の精霊も、ここを嫌って逃げたようだな。
FindingTemplePal	この汚れた寺院が、かつてわが教会の誇りであった場所か...。
FindingTempleSor	とてつもない邪悪の存在を感じるわ。
FindingTempleNec	闇がにじみ出してくる。
CompletingTempleAma	スカチムの時代が戻るね！
CompletingTempleBar	これでもう、暗黒の寺院が大地を汚すことはない。
CompletingTemplePal	これで再び光輝の力が蘇るであろう。
CompletingTempleSor	暗黒の力が消えたわ。オーマスに知らせなくちゃ。
CompletingTempleNec	寺院の暗き力は断たれた。
FindingGuardianTowerAma	ここにメフィストがいるんだね。
FindingGuardianTowerBar	ここが憎悪の巣くう場所か。
FindingGuardianTowerPal	ここが魔王メフィストの幽閉されし地か。
FindingGuardianTowerSor	メフィストの牢獄ね。
FindingGuardianTowerNec	メフィストを閉じこめた塔だな...
CompletingGuardianTowerAma	やっと倒した...なのに、この嫌な感じは何だ？
CompletingGuardianTowerBar	これで世界に平和が戻るだろう。
CompletingGuardianTowerPal	もはや憎悪の王が世界をおびやかすことはない。
CompletingGuardianTowerSor	もう、メフィストの憎悪が地上を汚すことはないわ。
CompletingGuardianTowerNec	故郷へ帰れ、メフィスト。地獄の深淵へ。
FreezingIzualAma	ちょっと、３つの願いは叶えてくれないの？
FreezingIzualBar	いくら堕天使でも、自由の権利はある。
FreezingIzualPal	かつて輝く天界に仕えし身が、なにゆえ悪徳に染まった？
FreezingIzualSor	可哀想に、魂の底まで汚されていたのね。
FreezingIzualNec	案外もろかったな。地獄の力を使いこなせずにいたか。
CapsJoinMenu4	     
CapsJoinMenu5	     
Guild 1	       
Guild 2	       
Guild 3	       
Guild 4	       
Guild 5	       
To Guild 5	          
To Guild 4	          
To Guild 3	          
To Guild 2	          
To Guild 1	          
CapsBnet9	      
CapsBnet10	                
CapsBnet11	             
CapsBnet12	          
CapsBnet13	            
CapsBnet14	                 
CapsBnet15	                                                           
CapsGuildName	          
CapsGuildTag	         
GuildText1	                            
GuildText2	                                     
Ladder3	            
Ladder7	          
gmGuildTitle	                  
gmGuildName	    
gmGuildTag	   
gmWWW	              
gmGuildCharter	              
gmGuildCurrentGolds	             
gmGuildNextLevel	           
gmGuildMaster	             
gmOfficer	       
gmName	    
gmClass	     
gmLevel	   
gmDonate	      
gmRemove	             
gmPal	   
gmSor	   
gmAma	   
gmNec	   
gmBar	   
gmChangeSym	                              
gmChangeCharter	                             
gmChangeWebLink	                                 
Guild Portal	            
createdguildsuccess	                                
createdguildfailure	                            
inviteguildsuccess	                      
inviteguildfailure	                        
inviteguildins	                                                                  
joinedguildsuccess	                               
joinedguildfailure	                     
quitguildsuccess	                                      
quitguildfailure	                     
guildentererror	                      
strGuildMasterKicked	                                 
strGuildPerk1	      
strGuildPerk2	              
strGuildPerk3	     
strGuildPerk4	             
strGuildPerk5	           
strGuildPerk6	                 
strGuildGoldDonated	               
strGuildDonateGold	                                                 
gmGuildCurrentGoldPopup	                     
gmGuildNextLevelPopup	                            
gmGuildDonateGoldPopup	                    
Message Board	             
Trophy Case	           
Guild Vault	           
Steeg Stone	           
guildaccepticon	                  
guildmsgtext	    
Eskillname0	          
Eskillsd0	          
Eskillld0	          
Eskillan0	          
EskillnameExp1	    
EskillsExpd1	           
EskilllExpd1	           
EskillExpan1	    
Eskillname2	     
Eskillsd2	                       
Eskillld2	                       
Eskillan2	     
Eskillname3	           
Eskillsd3	           
Eskillld3	                                                             
Eskillan3	           
Eskillname4	         
Eskillsd4	                   
Eskillld4	                              
Eskillan4	         
Eskillname5	         
Eskillsd5	                           
Eskillld5	                           
Eskillan5	         
Eskillname6	         
Eskillsd6	           
Eskillld6	                                 
Eskillan6	         
Eskillname7	    
Eskillsd7	                     
Eskillld7	                     
Eskillan7	    
Eskillname8	              
Eskillsd8	                       
Eskillld8	                       
Eskillan8	          
Eskillname9	            
Eskillsd9	                   
Eskillld9	                                     
Eskillan9	            
Eskillname10	           
Eskillsd10	                   
Eskillld10	                   
Eskillan10	           
Eskillname11	                
Eskillsd11	                
Eskillld11	                
Eskillan11	         
Eskillname12	    
Eskillsd12	                     
Eskillld12	                     
Eskillan12	    
Eskillname13	        
Eskillsd13	                 
Eskillld13	                                      
Eskillan13	        
Eskillname14	           
Eskillsd14	           
Eskillld14	           
Eskillan14	           
Eskillname15	          
Eskillsd15	                           
Eskillld15	                           
Eskillan15	          
Eskillname16	         
Eskillsd16	         
Eskillld16	                
Eskillan16	         
Eskillname17	     
Eskillsd17	     
Eskillld17	     
Eskillan17	     
Eskillname18	    
Eskillsd18	    
Eskillld18	    
Eskillan18	    
Eskillname19	       
Eskillsd19	                                
Eskillld19	                                
Eskillan19	       
Eskillname20	            
Eskillsd20	                    
Eskillld20	                    
Eskillan20	            
Eskillname21	       
Eskillsd21	                
Eskillld21	                                               
Eskillan21	       
Eskillname22	   
Eskillsd22	                         
Eskillld22	                         
Eskillan22	   
Eskillname23	       
Eskillsd23	                
Eskillld23	                
Eskillan23	       
Eskillname24	       
Eskillsd24	                
Eskillld24	                
Eskillan24	       
Eskillname25	               
Eskillsd25	                                
Eskillld25	                                
Eskillan25	               
Eskillname26	              
Eskillsd26	              
Eskillld26	              
Eskillan26	              
Eskillname27	           
Eskillsd27	                     
Eskillld27	                                            
Eskillan27	           
Eskillname28	          
Eskillsd28	          
Eskillld28	          
Eskillan28	          
Eskillname29	         
Eskillsd29	         
Eskillld29	         
Eskillan29	         
Eskillname30	           
Eskillsd30	                 
Eskillld30	                 
Eskillan30	           
Eskillname31	     
Eskillsd31	     
Eskillld31	                           
Eskillan31	     
Eskillname32	              
Eskillsd32	              
Eskillld32	              
Eskillan32	              
Eskillname33	             
Eskillsd33	             
Eskillld33	             
Eskillan33	             
Eskillname34	           
Eskillsd34	                  
Eskillld34	                       
Eskillan34	           
Eskillname35	           
Eskillsd35	                      
Eskillld35	                                      
Eskillan35	           
Eskillname36	             
Eskillsd36	                      
Eskillld36	                      
Eskillan36	             
Eskillname37	          
Eskillsd37	                    
Eskillld37	                                          
Eskillan37	          
Eskillname38	          
Eskillsd38	          
Eskillld38	          
Eskillan38	          
Eskillname39	             
Eskillsd39	             
Eskillld39	             
Eskillan39	             
Eskillname40	                   
Eskillsd40	                           
Eskillld40	                                        
Eskillan40	         
Eskillname41	               
Eskillsd41	                       
Eskillld41	                                       
Eskillan41	               
Eskillname42	               
Eskillsd42	               
Eskillld42	               
Eskillan42	               
Eskillname43	            
Eskillsd43	                            
Eskillld43	                                         
Eskillan43	            
Eskillname44	          
Eskillsd44	          
Eskillld44	          
Eskillan44	          
Eskillname45	          
Eskillsd45	          
Eskillld45	          
Eskillan45	          
Eskillname46	    
Eskillsd46	    
Eskillld46	    
Eskillan46	    
Eskillname47	            
Eskillsd47	            
Eskillld47	            
Eskillan47	            
Eskillname48	      
Eskillsd48	      
Eskillld48	      
Eskillan48	      
Eskillname49	                
Eskillsd49	                
Eskillld49	                
Eskillan49	                
Eskillname50	                
Eskillsd50	                        
Eskillld50	                                    
Eskillan50	                
Eskillname51	          
Eskillsd51	          
Eskillld51	          
Eskillan51	          
Eskillname52	          
Eskillsd52	          
Eskillld52	          
Eskillan52	          
Eskillname53	          
Eskillsd53	          
Eskillld53	          
Eskillan53	          
Eskillname54	             
Eskillsd54	             
Eskillld54	             
Eskillan54	             
Eskillname55	         
Eskillsd55	         
Eskillld55	         
Eskillan55	         
Eskillname56	            
Eskillsd56	            
Eskillld56	            
Eskillan56	            
Eskillname57	            
Eskillsd57	            
Eskillld57	            
Eskillan57	            
Eskillname58	              
Eskillsd58	              
Eskillld58	              
Eskillan58	              
Eskillname59	             
Eskillsd59	             
Eskillld59	             
Eskillan59	             
ESkillHawk	       
ESkillSpikes	        
ESkillStars	       
ESkillWolf	      
ESkillWolves	        
ESkillShoots	       
ESkillTimes	      
ESkillSpikes2	       
ob1	      
ob2	       
ob3	   
ob4	      
ob5	          
ne1	         
ne2	          
ne3	             
ne4	          
ne5	         
dr1	              
dr2	        
dr3	        
dr4	            
dr5	         
as1	     
as2	        
as3	        
as4	     
as5	    
as6	     
as7	     
AmaOnly	           
SorOnly	              
NecOnly	                
PalOnly	            
BarOnly	              
DruOnly	          
AssOnly	             
WeaponDescH2H	                  
Seige Tower	           
RotWalker	          
ReanimatedHorde	                
ProwlingDead	             
UnholyCorpse	             
DefiledWarrior	               
Seige Beast	           
CrushBiest	           
BloodBringer	             
GoreBearer	           
DeamonSteed	           
WailingSpirit	              
LifeSeeker	           
LifeStealer	            
DeathlyVisage	              
BoundSpirit	            
BanishedSoul	             
Deathexp	     
Minionexp	      
Slayerexp	      
IceBoar	        
FireBoar	         
HellSpawn	          
IceSpawn	         
GreaterHellSpawn	                  
GreaterIceSpawn	                 
FanaticMinion	              
BerserkSlayer	                
ConsumedFireBoar	                  
ConsumedIceBoar	                 
FrenziedHellSpawn	                   
FrenziedIceSpawn	                  
InsaneHellSpawn	                 
InsaneIceSpawn	                
Succubusexp	        
VileTemptress	              
StygianHarlot	              
BlightWing	           
BloodWitch	           
Dominus	       
VileWitch	          
StygianFury	            
MageWing	         
HellWitch	          
OverSeer	         
Lasher	      
OverLord	         
BloodBoss	          
HellWhip	         
MinionSpawner	              
MinionSlayerSpawner	                     
MinionIce/fireBoarSpawner	                   
Minionice/hellSpawnSpawner	                   
MinionGreaterIce/hellSpawnSpawner	                           
Imp1	   
Imp2	   
Imp3	   
Imp4	   
Imp5	   
ScrollFormat	%0 %1
BookFormat	%0 %1
HiqualityFormat	%0 %1
LowqualityFormat	%0 %1
HerbFormat	%0 %1
MagicFormat	%0 %1 %2
GemmedNormalName	%0 %1
BodyPartsFormat	%0 %1
PlayerBodyPartFormat	%0 %1
RareFormat	%0 %1
SetItemFormat	%0 %1
ChampionFormat	%0 %1
Monster1Format	%0 %1
Monster2Format	%0 %1 %2
Low Quality	劣悪な
Damaged	傷んだ
Cracked	ひび割れた
Crude	粗雑な
Hiquality	上等な
Gemmed	宝石入りの
Resiliant	強靱なる
Sturdy	頑丈なる
Strong	強き
Glorious	栄光の
Blessed	祝福されし
Saintly	聖者の
Holy	聖なる
Devious	不正の
Fortified	強固なる
Urgent	集中の
Fleet	素早き
Muscular	筋骨の
Jagged	鋸歯の
Deadly	死を呼ぶ
Vicious	悪意の
Brutal	残忍なる
Massive	剛腕の
Savage	野蛮なる
Merciless	冷酷なる
Vulpine	反骨の
Swift	俊敏なる
Artful	絶妙なる
Skillful	熟達の
Adroit	機敏なる
Tireless	疲れ知らずの
Rugged	強健の
Bronze	青銅の
Iron	鉄の
Steel	鋼の
Silver	銀の
Gold	黄金の
Platinum	プラチナの
Meteoric	流星の
Sharp	鋭利なる
Fine	精巧なる
Warrior's	戦士の
Soldier's	兵士の
Knight's	騎士の
Lord's	領主の
King's	王者の
Howling	咆吼する
Fortuitous	幸運の
Brilliant	輝ける
Omniscient	知の
Sage	英知の
Shrewd	狡知の
Vivid	躍動の
Glimmering	きらめく
Glowing	光る
Bright	明るい
Solar	太陽の
Lizard's	蜥蜴の
Forceful	気力の
Snake's	蛇の
Serpent's	大蛇の
Drake's	ドレイクの
Dragon's	ドラゴンの
Wyrm's	ワームの
Dazzling	眩惑の
Facinating	魅惑の
Prismatic	虹色の
Azure	蒼き
Lapis	ラピスの
Cobalt	コバルトの
Indigo	藍の
Sapphire	サファイアの
Cerulean	セルリアンの
Red	赤き
Crimson	深紅の
Burgundy	赤紫の
Garnet	ガーネットの
Russet	深き赤の
Ruby	ルビーの
Vermilion	朱の
Orange	オレンジの
Ocher	オーカーの
Tangerine	赤橙色の
Coral	珊瑚色の
Crackling	亀裂を入れる
Amber	琥珀の
Forked	叉になった
Green	緑の
Beryl	薄青の
Jade	翡翠の
Viridian	深緑の
Vital	活発なる
Emerald	エメラルドの
Enduring	不朽の
Fletcher's	矢羽職人の
Archer's	アーチャーの
Monk's	モンクの
Priest's	聖職者の
Summoner's	召喚術師の
Necromancer's	ネクロマンサーの
Angel's	天使の
Arch-Angel's	大天使の
Slayer's	殺戮者の
Berserker's	狂戦士の
Kicking	蹴撃の
Triumphant	凱歌の
Mighty	力強き
Energizing	活力の
Strengthening	強化の
Empowering	鉄腕の
Brisk	俊速の
Tough	タフネスの
Hardy	頑健の
Robust	堅固なる
of Health	（生命力）
of Protection	（守備）
of Absorption	（吸収）
of Warding	（防護）
of the Sentinel	（歩哨）
of Guarding	（防衛）
of Negation	（無効化）
of Piercing	（貫通）
of Bashing	（強打）
of Puncturing	（穿刺）
of Thorns	（棘）
of Spikes	（スパイク）
of Readiness	（快速）
of Alacrity	（機敏）
of Swiftness	（俊敏）
of Quickness	（素早さ）
of Blocking	（ブロック）
of Deflecting	（受け流し）
of the Apprentice	（学徒）
of the Magus	（司祭）
of Frost	（霜）
of the Glacier	（氷河）
of Warmth	（解氷）
of Flame	（炎）
of Fire	（火）
of Burning	（灼熱）
of Shock	（衝撃）
of Lightning	（稲妻）
of Thunder	（雷撃）
of Craftsmanship	（精妙）
of Quality	（上質）
of Maiming	（傷害）
of Slaying	（殺害）
of Gore	（残虐）
of Carnage	（殺戮）
of Slaughter	（虐殺）
of Worth	（価値）
of Measure	（保証）
of Excellence	（卓越）
of Performance	（高性能）
of Blight	（疾病）
of Venom	（毒）
of Pestilence	（悪疫）
of Dexterity	（敏捷）
of Skill	（技）
of Accuracy	（的確）
of Precision	（精度）
of Perfection	（完璧）
of Balance	（バランス）
of Stability	（安定）
of the Horse	（馬）
of Regeneration	（活力回復）
of Regrowth	（再生）
of Vileness	（堕落）
of Greed	（貪欲）
of Wealth	（富裕）
of Chance	（好機）
of Fortune	（幸運）
of Energy	（エネルギー）
of the Mind	（精神）
of Brilliance	（俊才）
of Sorcery	（魔道）
of Wizardry	（魔術）
of the Bear	（熊）
of Light	（光輝）
of Radiance	（光）
of the Sun	（太陽）
of Life	（生命）
of the Jackal	（ジャッカル）
of the Fox	（狐）
of the Wolf	（狼）
of the Tiger	（虎）
of the Mammoth	（マンモス）
of the Colosuss	（コロッサス）
of the Leech	（ヒル）
of the Locust	（バッタ）
of the Bat	（蝙蝠）
of the Vampire	（吸血鬼）
of Defiance	（不屈）
of Remedy	（治療）
of Amelioration	（向上）
of Ice	（氷）
of Simplicity	（簡便）
of Ease	（容易）
of the Mule	（ラバ）
of Strength	（腕力）
of Might	（強さ）
of the Ox	（雄牛）
of the Giant	（巨人）
of the Titan	（ティーターン）
of Pacing	（健脚）
of Haste	（迅速）
of Speed	（スピード）
cap	キャップ
skp	スカルキャップ
hlm	ヘルム
fhl	フル・ヘルム
ghm	グレイト・ヘルム
crn	冠
msk	マスク
qui	キルトのアーマー
lea	レザーアーマー
hla	ハードレザー・アーマー
stu	鋲つき革アーマー
rng	リングメイル
scl	スケールメイル
chn	チェーンメイル
brs	ブレストプレート
spl	スプリントメイル
plt	プレートメイル
fld	フィールドプレート
gth	ゴシックプレート
ful	フルプレートメイル
aar	古代のアーマー
ltp	 ライト・プレート 
buc	バックラー
sml	スモールシールド
lrg	ラージシールド
kit	カイトシールド
tow	タワーシールド
gts	ゴシックシールド
lgl	レザーグローブ
vgl	ヘヴィグローブ
mgl	チェーングローブ
tgl	ライトガントレット
hgl	ガントレット
lbt	ブーツ
vbt	ヘヴィブーツ
mbt	チェーンブーツ
tbt	ライトプレートブーツ
hbt	グリーヴ
lbl	サッシュ
vbl	ライトベルト
mbl	ベルト
tbl	ヘヴィベルト
hbl	プレートベルト
bhm	ボーンヘルム
bsh	ボーンシールド
spk	スパイクシールド
hax	ハンドアックス
axe	アックス
2ax	ダブルアックス
mpi	ミリタリー・ピック
wax	ウォーアックス
lax	ラージアックス
bax	ブロードアックス
btx	バトルアックス
gax	グレートアックス
gix	ジャイアントアックス
wnd	ワンド
ywn	木のワンド
bwn	ボーンワンド
gwn	グリムワンド
clb	クラブ
scp	セプター
gsc	グランドセプター
wsp	ウォーセプター
spc	スパイク付きクラブ
mac	メイス
mst	モーニングスター
fla	フレイル
whm	ウォーハンマー
mau	モール
gma	グレートモール
ssd	ショートソード
scm	シミター
sbr	サーベル
flc	フォルシオン
crs	クリスタルソード
bsd	ブロードソード
lsd	ロングソード
wsd	ウォーソード
2hs	両手用ソード
clm	クレイモア
gis	ジャイアントソード
bsw	バスタードソード
flb	フランベルジュ
gsd	グレートソード
dgr	ダガー
dir	短刀
kri	クリース
bld	ブレイド
tkf	投げナイフ
tax	投げアックス
bkf	バランスナイフ
bal	バランスアックス
jav	ジャベリン
pil	パイラム
ssp	ショートスピア
glv	グレイヴ
tsp	投げスピア
spr	スピア
tri	トライデント
brn	ブランディストック
spt	スペタム
pik	パイク
bar	バーダイク
vou	バウルジ
scy	大鎌
pax	ポールアックス
hal	ハルバード
wsc	戦争の大鎌
sst	ショート・スタッフ
lst	ロング・スタッフ
cst	節くれだったスタッフ
bst	バトル・スタッフ
wst	ウォー・スタッフ
sbw	ショートボウ
hbw	ハンターズ・ボウ
lbw	ロングボウ
cbw	複合ボウ
sbb	ショート・バトルボウ
lbb	ロング・バトルボウ
swb	ショート・ウォーボウ
lwb	ロング・ウォーボウ
lxb	ライト・クロスボウ
mxb	クロスボウ
hxb	ヘヴィ・クロスボウ
rxb	連射クロスボウ
xpk	有刺シールド
xsh	グリムシールド
xh9	グリムヘルム
zhb	ウォーベルト
ztb	バトルベルト
zmb	メッシュベルト
zvb	鮫皮ベルト
zlb	魔獣の皮のサッシュ
xhb	ウォーブーツ
xtb	バトルブーツ
xmb	メッシュブーツ
xvb	鮫皮ブーツ
xlb	魔獣の皮のブーツ
xhg	ウォー・ガントレット
xtg	バトル・ガントレット
xmg	重い弓籠手
xvg	鮫皮グローブ
xlg	魔獣の皮のグローブ
xts	古代のシールド
xow	パバイス
xit	ドラゴンシールド
xrg	スキュータム
xml	ラウンドシールド
xuc	ディフェンダー
xtp	魔道師のプレート
xar	装飾のプレート
xul	混沌のアーマー
xth	エンボスのプレート
xld	鮫の歯のアーマー
xlt	聖堂騎士のコート
xpl	ラセットアーマー
xrs	クゥイラス
xhn	メッシュアーマー
xcl	ティギュレート・メイル
xng	リンクト・メイル
xtu	格子のアーマー
xla	魔獣の皮のアーマー
xea	蛇皮のアーマー
xui	ゴーストアーマー
xsk	デスマスク
xrn	大いなる冠
xhm	ウィングヘルム
xhl	バシネット
xlm	カスク
xkp	サレット
xap	ウォー・ハット
8rx	チュコヌ
8hx	バリスタ
8mx	攻城クロスボウ
8lx	アルバレスト
8lw	ゴシック・ボウ
8sw	ルーン・ボウ
8l8	大攻城弓
8s8	短攻城弓
8cb	ダブルボウ
8lb	シダーの弓
8hb	剃刀の弓
8sb	エッジ・ボウ
8ws	ルーン・スタッフ
8bs	ゴシック・スタッフ
8cs	シダーのスタッフ
8ls	クォータースタッフ
8ss	ジョウのスタッフ
9wc	死の大鎌
9h9	ベクドコービン
9pa	パルチザン
9s8	戦いの大鎌
9vo	長鉾
9b7	ロッホアーバー・アックス
9p9	ランス
9st	東洋の槍
9br	ウォー・フォーク
9tr	フシナ
9sr	ウォー・スピア
9ts	ハープーン
9gl	スピキュラム
9s9	シンビラン
9pi	グレートパイラム
9ja	ウォージャベリン
9b8	ハールバット
9bk	ウォー・ダート
9ta	フランシスカ
9tk	バトルダート
9bl	スティレット
9kr	チンクエデア
9di	ロンデル
9dg	ポイグナード
9gd	処刑人のソード
9fb	ツヴァイハンダー
9gs	タスク・ソード
9cm	ダキアの鎌
92h	エスパンドン
9wd	古代のソード
9ls	ルーンソード
9bs	バトルソード
9cr	ディメンショナル・ブレイド
9fc	タルワール
9sb	シャムシール
9sm	カットラス
9ss	グラディウス
9gm	マーテル・ドゥ・フェール
9m9	ウォー・クラブ
9wh	バトルハンマー
9fl	むち
9mt	鋸歯のスター
9ma	フランジド・メイス
9sp	有刺クラブ
9ws	ディバイン・セプター
9qs	聖水スプリンクラー
9sc	新米のセプター
9cl	カジェル
9gw	グレイブワンド
9bw	トゥームワンド
9yw	硬いワンド
9wn	焦げたワンド
9gi	古代のアックス
9ga	ゴシックアックス
9bt	テイバー
9ba	鉤付きアックス
9la	ミリタリーアックス
9wa	ナーガ
9mp	クロウビル
92a	ツインアックス
9ax	クリーヴァー
9ha	ハチェット
9b9	ゴシック・ソード
gpl	刺激ガスポーション
opl	可燃ポーション
gpm	窒息ガスポーション
opm	爆発ポーション
gps	悪臭ガスポーション
ops	オイルポーション
gidbinn	ギドビン
g33	ザ・ギドビン
d33	おとりのギドビン
leg	ワートの脚
Malus	ホラドリック・マリュス
hdm	ホラドリック・マリュス
hfh	地獄の炉の槌
hst	ホラドリムの杖
msf	ホラドリムの杖の軸
orifice	台座
elx	エリクサー
tbk	タウンポータルの書
tsc	タウンポータルの巻物
ibk	鑑定の書
isc	鑑定の巻物
RightClicktoUse	右クリックで使う
RightClicktoOpen	右クリックで開く
RightClicktoRead	右クリックで読む
InsertScrolls	巻物を挿入
vps	スタミナポーション
yps	解毒ポーション
rvs	回復ポーション
rvl	完全回復ポーション
wms	解氷ポーション
amu	護符
vip	ホラドリムの杖の頭
rin	リング
gld	ゴールド
bks	イニファスの巻物
bkd	ケルンの輪の解き方
aqv	矢
tch	たいまつ
cqv	ボルト
Key	鍵
key	鍵
luv	黒き塔の鍵
xyz	右クリックでライフを永久に20アップ \n生命のポーション
shrine	ほこら
teleport pad	テレポートパッド
j34	翡翠の小像
g34	黄金の鳥
bbb	ラム・エセンの書
LamTome	ラム・エセンの書
box	ホラドリムのキューブ
tr1	ホラドリムの巻物
mss	メフィストのソウルストーン
ass	右クリックし、望むスキルを修得 \nスキルの書
ear	耳
gcv	欠けたアメジスト
gfv	傷のあるアメジスト
gsv	アメジスト
gzv	無傷のアメジスト
gpv	完璧なアメジスト
gcy	欠けたトパーズ
gfy	傷のあるトパーズ
gsy	トパーズ
gly	無傷のトパーズ
gpy	完璧なトパーズ
gcb	欠けたサファイア
gfb	傷のあるサファイア
gsb	サファイア
glb	無傷のサファイア
gpb	完璧なサファイア
gcg	欠けたエメラルド
gfg	傷のあるエメラルド
glg	無傷のエメラルド
gsg	エメラルド
gpg	完璧なエメラルド
gcr	欠けたルビー
gfr	傷のあるルビー
gsr	ルビー
glr	無傷のルビー
gpr	完璧なルビー
gcw	欠けたダイアモンド
gfw	傷のあるダイアモンド
gsw	ダイアモンド
glw	無傷のダイアモンド
gpw	完璧なダイアモンド
hp1	マイナーヒーリング・ポーション
hp2	ライトヒーリング・ポーション
hp3	ヒーリング・ポーション
hp4	グレートヒーリング・ポーション
hp5	スーパーヒーリング・ポーション
mp1	マイナーマナ・ポーション
mp2	ライトマナ・ポーション
mp3	マナ・ポーション
mp4	グレートマナ・ポーション
mp5	スーパーマナ・ポーション
hrb	ハーブ
skc	欠けた頭蓋骨
skf	傷のある頭蓋骨
sku	頭蓋骨
skl	無傷の頭蓋骨
skz	完璧な頭蓋骨
Beast	獣の
Eagle	鷲の
Raven	鴉の
Viper	毒蛇の
GhoulRI	グールの
Skull	頭蓋骨の
Blood	血の
Dread	恐怖の
Doom	破滅の
Grim	残忍なる
Bone	骨の
Death	死の
Shadow	影の
Storm	嵐の
Rune	ルーンの
PlagueRI	悪疫の
Stone	石の
Wraith	生霊の
Spirit	霊魂の
Demon	魔獣の
Cruel	残酷な
Empyrion	天空の
Bramble	イバラの
Pain	苦痛の
Loath	嫌悪の
Glyph	グリフの
Imp	小鬼の
Fiend	フィーンドの
Hailstone	雹の
Gale	烈風の
Dire	壮烈なる
Soul	魂の
Brimstone	硫黄の
Corpse	屍
Carrion	死肉の
Holocaust	ハルマゲドンの
Havoc	大乱の
Bitter	苦き
Entropy	エントロピーの
Chaos	混沌の
Order	秩序の
Rift	不和の
Corruption	腐敗の
bite	咬撃
scratch	掻撃
scalpel	小刀
fang	牙
gutter	屠殺刀
thirst	渇き
razor	剃刀
scythe	大鎌
edge	刃
saw	鋸
splitter	スプリッター
cleaver	クリーヴァー
sever	斬殺者
sunder	切断者
rend	斬撃
mangler	乱撃
slayer	殺戮者
reaver	略奪者
Spawn	申し子
gnash	歯ぎしり
star	星
blow	旋撃
smasher	破砕者
Bane	殺人者
crusher	粉砕者
breaker	破壊者
grinder	殲滅者
crack	痛撃
mallet	小槌
knell	弔鐘
lance	ランス
spike	スパイク
impaler	貫通者
skewer	スキューアー
prod	刺突
scourge	天誅
wand	ワンド
wrack	拷問
barb	鉤
needle	針
dart	ダート
bolt	ボルト
quarrel	争乱
fletch	フレッチ
flight	飛行
nock	弓筈
horn	角
stinger	スティンガー
quill	羽柄
goad	突き棒
branch	枝
spire	スパイア
song	歌
call	呼び声
cry	絶叫
spell	呪文
chant	聖歌
weaver	織り師
gnarl	瘤
visage	覆面
crest	冠兜
circlet	鉢金
veil	ヴェール
hood	フード
mask	マスク
brow	額あて
casque	カスク
visor	バイザー
cowl	頭巾
hide	皮
Pelt	毛皮
carapace	甲羅
coat	コート
wrap	巻き布
suit	スーツ
cloak	クローク
shroud	屍衣
jack	革胴
mantle	マント
guard	ガード
badge	バッヂ
rock	岩
aegis	イージス
ward	防護
tower	塔
shield	シールド
wing	翼
mark	マーク
emblem	エンブレム
hand	手
fist	拳
claw	鉤爪
clutches	握り
grip	グリップ
grasp	保持
hold	ホールド
touch	接触
finger	指
knuckle	ナックル
shank	脛
spur	拍車
tread	靴底
stalker	ストーカー
greave	グリーヴ
blazer	ブレイザー
nails	爪
trample	蹂躙
Brogues	短靴
track	追跡
slippers	軽靴
clasp	留め金
buckle	バックル
harness	ハーネス
lock	ロック
fringe	フリンジ
winding	帯
chain	鎖
strap	ストラップ
lash	綱
cord	紐
knot	結び目
circle	サークル
loop	ループ
eye	小環
turn	回転
spiral	螺旋
coil	コイル
gyre	輪
band	バンド
whorl	渦
talisman	タリスマン
heart	ハート
noose	輪縄
necklace	ネックレス
collar	襟
beads	ビーズ
torc	首鎖
gorget	襟章
scarab	スカラベ
wood	木
brand	燃え木
bludgeon	ブラジオン
cudgel	カジェル
loom	竿
harp	ハープ
master	マスター
barRI	バー
hew	切断
crook	鈎
mar	殺傷
shell	殻
stake	杭
picket	ピケット
pale	ペイル
flange	フランジ
Civerb's Vestments	シバーブの衣服
Hsarus' Trim	フサルの備え
Cleglaw's Brace	クレグローの装具
Iratha's Finery	イラーサの装飾品
Isenhart's Armory	アンゼンハートの武具
Vidala's Rig	ビダラの衣装
Milabrega's Regalia	ミラブレガの礼装
Cathan's Traps	カサンのトラップ
Tancred's Battlegear	タンクレッドのバトルギア
Sigon's Complete Steel	サイゴンの鋼
Infernal Tools	冥界の道具
Berserker's Garb	狂戦士の兵器庫
Death's Disguise	死神の変装
Angelical Raiment	天使の服
Arctic Gear	極地の装備
Arcanna's Tricks	アルカナのたくらみ
Civerb's	シバーブの
Hsarus'	フサルの
Cleglaw's	クレグローの
Iratha's	イラーサの
Isenhart's	アイゼンハートの
Vidala's	ビダラの
Milabrega's	ミラブレガの
Cathan's	カサンの
Tancred's	タンクレッドの
Sigon's	サイゴンの
Infernal	冥界の
Berserker's	狂戦士の
Death's	死神の
Angelical	天使の
Arctic	極地の
Arcanna's	アルカナの
Ward	防護
Iron Heel	鉄のかかと
Tooth	歯
Collar	襟
Lightbrand	ライトブランド
Barb	鉤
Orb	宝玉
Rule	ルール
Crowbill	クロウビル
Visor	バイザー
Cranium	頭骨
Headgear	ヘッドギア
Hand	手
Sickle	手鎌
Horn	角
Sign	サイン
Icon	聖像
Iron Fist	鉄拳
Claw	鉤爪
Cuff	袖小手
Parry	防御
Fetlock	足枷
Rod	ロッド
Mesh	メッシュ
Spine	棘
Shelter	シェルター
Torch	たいまつ
Hauberk	ホーバーク
Guard	ガード
Mantle	マント
Furs	毛皮
Deathwand	死のワンド
CudgelSI3S	カジェル
Iron Stay	鉄帯
Pincers	鉄手袋
Coil	コイル
Case	胴丸
Ambush	伏兵
Diadem	冠輪
Visage	覆面
Hobnails	ホブネイル
Gage	籠手
SignSI3S	バックル
Hatchet	ハチェット
Touch	たいまつ
Halo	光輪
Binding	帯
Head	頭
Horns	角
Snare	誘惑
Robe	ローブ
Sigil	印璽
Weird	宿命
Sabot	木靴
Wings	翼
Mitts	手袋
Flesh	肉
Cord	紐
Seal	封印
SkullSI5S	頭蓋骨
Wrap	巻き布
GuardSI6S	ガード
The Gnasher	唸る斧
Deathspade	死のスペード
Bladebone	肩胛骨
Mindrend	スカル・スプリッター
Rakescar	レイク・スカー
Fechmars Axe	フェチマーのアックス
Goreshovel	残虐のシャベル
The Chieftan	チーフテン
Brainhew	ブレインヒュー
The Humongous	ヒューモンガス
Iros Torch	イロのたいまつ
Maelstromwrath	大渦
Gravenspine	グレイヴンスパイン
Umes Lament	ウーメの哀歌
Felloak	フェルオーク
Knell Striker	弔鐘の杖
Rusthandle	ルストハンドル
Stormeye	ストームアイ
Stoutnail	スタウトネイル
Crushflange	クラッシュフランジ
Bloodrise	ブラッドライズ
The Generals Tan Do Li Ga	将軍のタンドリガ
Ironstone	アイアンストーン
Bonesob	ボーンスナップ
Steeldriver	スチールドライバー
Rixots Keen	リクソットの鋭刃
Blood Crescent	鮮血の三日月
Krintizs Skewer	クリンティズのスキューアー
Gleamscythe	光る大鎌
Azurewrath	アズアラス
Griswolds Edge	グリスワルドの刃
Hellplague	地獄の悪疫
Culwens Point	カルウェンの切っ先
Shadowfang	シャドウファング
Soulflay	魂の略奪者
Kinemils Awl	キネミルの突き
Blacktongue	黒き舌
Ripsaw	大鋸
The Patriarch	ペイトリアーク
Gull	ガル
The Diggler	ディグラー
The Jade Tan Do	翡翠のタンドゥ
Irices Shard	虹色のかけら
The Dragon Chang	ドラゴン・チャン
Razortine	剃刀歯
Bloodthief	ブラッドシーフ
Lance of Yaggai	ヤッガイのランス
The Tannr Gorerod	タン・ゴアロッド
Dimoaks Hew	ディモークの切断
Steelgoad	スチールゴード
Soul Harvest	ソウル・ハーベスト
The Battlebranch	バトルブランチ
Woestave	哀しみの棒
The Grim Reaper	グリムリーパー
Bane Ash	ベイン・アッシュ
Serpent Lord	大蛇の王
Lazarus Spire	ラザラスのスパイア
The Salamander	サラマンダー
The Iron Jang Bong	鉄のジャンボン
Pluckeye	プラックアイ
Witherstring	衰弱の糸
Rimeraven	鴉の鉤爪
Piercerib	ローグの弓
Pullspite	ストームストライク
Wizendraw	ウィザンドロー
Hellclap	ヘルクラップ
Blastbark	ブラストバーク
Leadcrow	鉛の鴉
Ichorsting	イコルスティング
Hellcast	ヘルキャスト
Doomspittle	ドゥームスリンガー
War Bonnet	ビギンのボンネット
Tarnhelm	ターンヘルム
Coif of Glory	栄光のコイフ
Duskdeep	ダスクディープ
Wormskull	ワームスカル
Howltusk	ハウルタスク
Undead Crown	アンデッドの冠
The Face of Horror	恐怖の顔
Greyform	グレイフォーム
Blinkbats Form	ブリンクバットの影
The Centurion	センチュリオン
Twitchthroe	断末魔の痙攣
Darkglow	ダークグロー
Hawkmail	ホークメイル
Sparking Mail	火花のメイル
Venomsward	ベノム・ウォード
Iceblink	アイスブリンク
Boneflesh	ボーンフレッシュ
Rockfleece	ロックフリース
Rattlecage	ラトルケージ
Goldskin	ゴールドスキン
Victors Silk	勝者の絹
Heavenly Garb	天の衣
Pelta Lunata	ペルタ・ルナータ
Umbral Disk	影法師のディスク
Stormguild	ストームギルド
Wall of the Eyeless	瞳なき壁
Swordback Hold	ソードバック・ホールド
Steelclash	スチールクラッシュ
Bverrit Keep	ブベリット・キープ
The Ward	防護
The Hand of Broc	ブロクの手
Bloodfist	ブラッドフィスト
Chance Guards	チャンスガード
Magefist	魔道師の拳
Frostburn	フロストバーン
Hotspur	ホットスパー
Gorefoot	ゴアフット
Treads of Cthon	クソンの足形
Goblin Toe	ゴブリンのつま先
Tearhaunch	ティアホーンチ
Lenyms Cord	レナイモ
Snakecord	スネークコード
Nightsmoke	ナイトスモーク
Goldwrap	ゴールドラップ
Bladebuckle	ブレイドバックル
Nokozan Relic	ノコザンの遺品
The Eye of Etlich	エトリッチの目
The Mahim-Oak Curio	マヒンオークの骨董
Nagelring	ネイジェルリング
Manald Heal	マナルド・ヒール
Gorgethroat	ジョージスロート
Amulet of the Viper	毒蛇の護符
Staff of Kings	王者の杖
Horadric Staff	ホラドリムの杖
Hell Forge Hammer	地獄の炉の槌
The Stone of Jordan	ヨルダンの石
GloomUM	グルーム・
Gray	グレイ・
DireUM	ダイア・
Black	ブラック・
ShadowUM	シャドウ・
Haze	ヘイズ・
Wind	ウィンド・
StormUM	ストーム・
Warp	ウォープ・
Night	ナイト・
Moon	ムーン・
Star	スター・
Pit	ピット・
Fire	フレイム・
Cold	アイス・
Seethe	シィーズ・
SharpUM	シャープ・
AshUM	アッシュ・
Blade	ブレイド・
SteelUM	スチール・
StoneUM	ストーン・
Rust	ルスト・
Mold	モールド・
Blight	ブライト・
Plague	プラーグ・
Rot	ロット・
Ooze	ウーズ・
Puke	ピューク・
Snot	スノット・
Bile	バイル・
BloodUM	ブラッド・
Pulse	パルス・
Gut	ガット・
Gore	ゴア・
FleshUM	フレッシュ・
BoneUM	ボーン・
SpineUM	スパイン・
Mind	マインド・
SpiritUM	スピリット・
SoulUM	ソウル・
Wrath	ラス・
GriefUM	グリーフ・
Foul	フォウル・
Vile	ヴァイル・
Sin	シン・
ChaosUM	ケイオス・
DreadUM	ドレッド・
DoomUM	ドゥーム・
BaneUM	ベイン・
DeathUM	デス・
ViperUM	ヴァイパー・
Dragon	ドラゴン・
Devil	デビル・
touchUM	タッチ
spellUM	スペル
feast	フェスト
wound	ウーンド
grin	グリン
maim	メイム
hack	ハック
biteUM	バイト
rendUM	レンド
burn	バーン
rip	リッパー
kill	キル
callUM	コール
vex	ヴェックス
jade	ジェイド
web	ウェブ
shieldUM	シールド
KillerUM	キラー
RazorUM	レイザー
drinker	ドリンカー
shifter	シフター
crawler	クローラー
dancer	ダンサー
bender	ベンダー
weaverUM	ウィーバー
eater	イーター
widow	ウィドウ
maggot	マゴット
spawn	スポーン
wight	ワイト
GrumbleUM	グランブル
GrowlerUM	グロウラー
SnarlUM	スナール
wolf	ウルフ
crow	クロウ
raven	レイヴン
hawk	ホーク
cloud	クラウド
BangUM	バン
head	ヘッド
skullUM	スカル
browUM	ブロウ
eyeUM	アイ
maw	モウ
tongue	タン
fangUM	ファング
hornUM	ホーン
thorn	ソーン
clawUM	クロウ
fistUM	フィスト
heartUM	ハート
shankUM	シャンク
skinUM	スキン
wingUM	ウィング
pox	ポックス
fester	フェスター
blister	ブリスター
pus	パス
SlimeUM	スライム
drool	ドルール
froth	フロス
sludge	スラッジ
venom	ベノム
poison	ポイズン
break	ブレイク
shard	シャード
flame	フレイム
maul	モール
thirstUM	サースト
lust	ラスト
the Hammer	・ザ・ハンマー
the Axe	・ジ・アックス
the Sharp	・ザ・シャープ
the Jagged	・ザ・ジャグド
the Flayer	・ザ・フレイヤー
the Slasher	・ザ・スラッシャー
the Impaler	・ジ・インペイラー
the Hunter	・ザ・ハンター
the Slayer	・ザ・スレイヤー
the Mauler	・ザ・モーラー
the Destroyer	・ザ・デストロイヤー
theQuick	・ザ・クイック
the Witch	・ザ・ウィッチ
the Mad	・ザ・マッド
the Wraith	・ザ・レイス
the Shade	・ザ・シェイド
the Dead	・ザ・デッド
the Unholy	ジ・アンホーリー
the Howler	・ザ・ハウラー
the Grim	・ザ・グリム
the Dark	・ザ・ダーク
the Tainted	・ザ・テインテッド
the Unclean	・ジ・アンクリーン
the Hungry	・ザ・ハングリー
the Cold	・ザ・コールド
The Cow King	牛の王
Grand Vizier of Chaos	混沌の宰相
Lord De Seis	セイスの王
Infector of Souls	魂を汚す者
Riftwraith the Cannibal	人喰いリフトレイス
Taintbreeder	テイントブリーダー
The Tormentor	拷問者
Winged Death	ダークウィング
Maffer Dragonhand	龍の手のマッファー
Wyand Voidfinger	虚無を呼ぶワイアンド
Toorc Icefist	氷の拳のトーク
Bremm Sparkfist	火花の拳のブレム
Geleb Flamefinger	炎の指のジェラブ
Ismail Vilehand	悪しき手のイスメイル
Icehawk Riftwing	アイスホーク・リフトウィング
Sarina the Battlemaid	戦う侍女サリナ
Stormtree	ストームツリー
Witch Doctor Endugu	呪医エンドゥグ
Web Mage the Burning	劫火のスザーク
Bishibosh	ビシボシュ
Bonebreak	ボーンブレイカー
Coldcrow	コールドクロウ
Rakanishu	ラカニシュ
Treehead WoodFist	樹の拳のツリーヘッド
Griswold	グリスワルド
The Countess	伯爵夫人
Pitspawn Fouldog	ピットスポーン・ファウルドッグ
Flamespike the Crawler	フレイムスパイク・ザ・クロウラー
Boneash	ボーンアッシュ
Radament	ラダメント
Bloodwitch the Wild	猛々しきブラッドウィッチ
Fangskin	ファングスキン
Beetleburst	ビートルバースト
Leatherarm	クリーピング・フィーチャー
Coldworm the Burrower	地に潜みしコールドワーム
Fire Eye	ファイア・アイ
Dark Elder	ダーク・エルダー
The Summoner	召喚術師
Ancient Kaa the Soulless	いにしえのカー
The Smith	鍛冶師
DeckardCain	デッカード・ケイン
Gheed	ギード
Akara	アカラ
Kashya	カシャ
Charsi	チャルシ
Wariv	ワリヴ
Warriv	ワリヴ
Rogue	ローグ族
StygianDoll	スティジアン・ドール
SoulKiller	ソウル・キラー
Flayer	フレイヤー
Fetish	フェティッシュ
RatMan	ラットマン
Undead StygianDoll	アンデッド・スティジアン・ドール
Undead SoulKiller	アンデッド・ソウルキラー
Undead Flayer	アンデッド・フレイヤー
Undead Fetish	アンデッド・フェティッシュ
Undead RatMan	アンデッド・ラットマン
DarkFamiliar	ダーク・ファミリアー
BloodDiver	ブラッドダイバー
Gloombat	グルームバット
DesertWing	デザートウィング
Banished	ザ・バニッシュト
BloodLord	ブラッドロード
DarkLord	ダークロード
NightLord	ナイトロード
GhoulLord	グールロード
Spikefist	スパイクフィスト
Thrasher	スラッシャー
BrambleHulk	ブランブル・ハルク
ThornedHulk	ソーン・ハルク
SpiderMagus	スパイダー・メイガス
FlameSpider	フレイム・スパイダー
PoisonSpinner	ポイズン・スピナー
SandFisher	サンドフィッシャー
Arach	アラクニッド
BloodWing	ブラッドウィング
BloodHook	ブラッドフック
Feeder	フィーダー
Sucker	サッカー
WingedNightmare	ウィングド・ナイトメア
HellBuzzard	ヘル・バザード
UndeadScavenger	アンデッド・スカヴェンジャー
CarrionBird	キャリオンバード
Unraveler	アンラヴェラー
Guardian	ガーディアン
HollowOne	ホロウ・ワン
Horadrim Ancient	古代のホラドリム
AlbinoRoach	ボーン・スカラベ
SteelWeevil	スティール・スカラベ
Scarab	スカラベ
SandWarrior	デスビートル
DungSoldier	ダング・ソルジャー
HellSwarm	ヘル・スウォーム
PlagueBugs	プラーグ・バグズ
BlackLocusts	ブラック・ローキャスツ
Itchies	イッチーズ
HellCat	ヘルキャット
NightTiger	ナイトタイガー
SaberCat	セイバーキャット
Huntress	ハントレス
RazorPitDemon	クリフ・ラーカー
TreeLurker	ツリー・ラーカー
CaveLeaper	ケイヴ・リーパー
TombCreeper	トゥーム・クリーパー
SandLeaper	サンド・リーパー
TombViper	トゥーム・ヴァイパー
PitViper	ピット・ヴァイパー
Salamander	サラマンダー
ClawViper	クロウ・ヴァイパー
SerpentMagus	サーペント・メイガス
WorldKiller	ブラッド・マゴット
GiantLamprey	ジャイアント・ランプリー
Devourer	ディヴァウラー
RockWorm	ロックワーム
SandMaggot	サンドマゴット
JungleUrchin	ジャングル・アーチン
RazorSpine	レイザー・スパイン
ThornBeast	ソーン・ビースト
SpikeFiend	スパイク・フィーンド
QuillRat	クィル・ラット
HellClan	ヘル・クラン
MoonClan	ムーン・クラン
NightClan	ナイト・クラン
DeathClan	デス・クラン
BloodClan	ブラッド・クラン
TempleGuard	テンプル・ガード
DoomApe	ドゥーム・エイプ
JungleHunter	ジャングルハンター
RockDweller	ロック・ドゥエラー
DuneBeast	デューン・ビースト
FleshHunter	フレッシュ・ハンター
BlackRogue	ブラック・ローグ
DarkStalker	ダークストーカー
VileHunter	ヴァイル・ハンター
DarkHunter	ダーク・ハンター
DarkShape	暗き影
Apparition	アパリシオン
Specter	スペクター
Wraith	レイス
Ghost	ゴースト
Assailant	アセイラント
Infidel	インフィデル
Invader	インヴェイダー
Marauder	マロウダー
SandRaider	サンド・レイダー
GargantuanBeast	ガルガンチュアン・ビースト
WailingBeast	ウェイリング・ビースト
Yeti	イエティ
Crusher	クラッシャー
Brute	ブルート
CloudStalker	クラウドストーカー
BlackVulture	ブラック・ヴァルチャー
BlackRaptor	ブラック・ラプター
BloodHawk	ブラッド・ホーク
FoulCrow	ファウル・クロウ
PlagueBearer	プラーグ・ベアラー
Ghoul	グール
DrownedCarcass	ドラウンド・カーカス
HungryDead	ハングリー・デッド
Zombie	ゾンビー
Skeleton	スケルトン
Horror	ホラー
Returned	リターンド
BurningDead	バーニング・デッド
BoneWarrior	ボーン・ウォリアー
Damned	呪われし者
Disfigured	ディスフィギュアード
Misshapen	ミスハプン
Tainted	テインテッド
Afflicted	アフリクテッド
Andariel	アンダリエル
Natalya	ナターリャ
Drognan	ドログナン
Atma	アトマ
Fara	ファラ
Lysander	ライサンダー
Jerhyn	ジェリン
jerhyn	ジェリン
Geglash	ゲグラッシュ
Elzix	エルジックス
Greiz	グレイズ
Meshif	メシフ
Camel	キャメル
Cadaver	キャダヴァー
PreservedDead	プリザーブド・デッド
Embalmed	エンバームド
DriedCorpse	ドライド・コープス
Decayed	ディケイド
Urdar	ウルダル
Mauler	モーラー
Gorbelly	ゴアベリー
Blunderbore	ブランダー・ボア
WorldKillerYoung	ブラッド・マゴットの幼虫
GiantLampreyYoung	ジャイアント・ランプリーの幼虫
DevourerYoung	ディヴァウラーの幼虫
RockWormYoung	ロックワームの幼虫
SandMaggotYoung	サンドマゴットの幼虫
WorldKillerEgg	ブラッドマゴットの卵
GiantLampreyEgg	ジャイアント・ランプリーの卵
DevourerEgg	ディヴァウラーの卵
RockWormEgg	ロックワームの卵
SandMaggotEgg	サンドマゴットの卵
Maggot	マゴット
Duriel	ドゥリエル
BloodHawkNest	ブラッドホークの巣
FlyingScimitar	フライング・シミター
CloudStalkerNest	クラウドストーカーの巣
BlackVultureNest	ブラックラプターの巣
FoulCrowNest	ファウルクロウの巣
Diablo	ディアブロ
Baal	バール
Mephisto	メフィスト
Cantor	キャンター
Heirophant	ハイエロファント
Sexton	セクストン
Zealot	ゼロット
Faithful	フェイスフル
Zakarumite	ザカラム信徒
BlackSoul	ブラック・ソウル
BurningSoul	バーニング・ソウル
SwampGhost	スワンプ・ゴースト
Gloam	グローム
WarpedShaman	ウォープト・シャーマン
DarkShaman	ダーク・シャーマン
DevilkinShaman	デヴィルキン・シャーマン
CarverShaman	カーヴァー・シャーマン
FallenShaman	フォールン・シャーマン
WarpedFallen	ウォープト
DarkOne	ダーク・ワン
Devilkin	デヴィルキン
Carver	カーヴァー
Fallen	フォールン
ReturnedArcher	リターンド・アーチャー
HorrorArcher	ホラー・アーチャー
BurningDeadArcher	バーニング・デッド・アーチャー
BoneArcher	ボーン・アーチャー
CorpseArcher	コープス・アーチャー
SkeletonArcher	スケルトン・アーチャー
FleshLancer	フレッシュ・ランサー
BlackLancer	ブラック・ランサー
DarkLancer	ダーク・ランサー
VileLancer	ヴァイル・ランサー
DarkSpearwoman	ダーク・スピアウーマン
FleshArcher	フレッシュ・アーチャー
BlackArcher	ブラック・アアーチャー
DarkRanger	ダーク・レンジャー
VileArcher	ヴァイル・アーチャー
DarkArcher	ダーク・アーチャー
Summoner	召喚術師
StygianDollShaman	スティジアン・ドール・シャーマン
SoulKillerShaman	ソウルキラー・シャーマン
FlayerShaman	フレイヤー・シャーマン
FetishShaman	フェティッシュシャーマン
RatManShaman	ラットマン・シャーマン
HorrorMage	ホラー・メイジ
BurningDeadMage	バーニング・デッド・メイジ
BoneMage	ボーン・メイジ
CorpseMage	コープス・メイジ
ReturnedMage	リターンド・メイジ
GargoyleTrap	ガーゴイル・トラップ
Bloodraven	ブラッド・レイヴン
navi	フラァヴィ
Kaelan	カエラン
meshif	メシフ
StygianWatcherHead	スティジアン・ウォッチャー
RiverStalkerHead	リバー・ストーカー
WaterWatcherHead	ウォーターウォッチャー
StygianWatcherLimb	スティジアン・ウォッチャー
RiverStalkerLimb	リバー・ストーカー
WaterWatcherLimb	ウォーターウォッチャー
NightMarauder	ナイト・マロウダー
FireGolem	ファイアゴーレム
IronGolem	アイアンゴーレム
BloodGolem	ブラッドゴーレム
ClayGolem	クレイゴーレム
WorldKillerQueen	ブラッドマゴット・クィーン
GiantLampreyQueen	ジャイアント・ランプリー・クィーン
DevourerQueen	ディヴァウラー・クィーン
RockWormQueen	ロックワーム・クィーン
SandMaggotQueen	サンドマゴット・クィーン
Slime Prince	スライム・プリンス
Bog Creature	ボグ・クリーチャー
Swamp Dweller	スワンプ・ドゥエラー
GiantUrchin	ジャイアント・アーチン
RazorBeast	レイザービースト
ThornBrute	ソーン・ブルート
SpikeGiant	スパイク・ジャイアント
QuillBear	クィルベア
Council Member	長老議会議員
youngdiablo	黒衣の放浪者
darkwanderer	黒衣の放浪者
HellSlinger	ヘル・スリンガー
NightSlinger	ナイト・スリンガー
SpearCat	スピアキャット
Slinger	スリンガー
FireTower	火の塔
LightningSpire	稲妻の塔
PitLord	ピット・ロード
Balrog	バルログ
VenomLord	ヴェノム・ロード
Iron Wolf	鉄狼団員
InvisoSpawner	インビソ・スポーナー
OblivionKnight	オブリビオン・ナイト
Mage	メイジ
AbyssKnight	アビス・ナイト
Fighter Mage	ファイター・メイジ
DoomKnight	ドゥーム・ナイト
Fighter	ファイター
MawFiend	モー・フィーンド
CorpseSpitter	コープス・スピッター
Corpulent	コピュラント
StormCaster	ストームキャスター
Strangler	ストラングラー
Groper	ドゥームキャスター
GrotesqueWyrm	グロテスクワーム
StygianDog	スティジアン・ドッグ
FleshBeast	フレッシュビースト
Grotesque	グロテスク
StygianHag	スティジアン・ハッグ
FleshSpawner	フレッシュスポーナー
RogueScout	ローグ・スカウト
BloodWingNest	ブラッド・ウィングの巣
BloodHookNest	ブラッドフックの巣
FeederNest	フィーダーの巣
SuckerNest	サッカーの巣
NecroMage	ネクロメイジ
NecroSkeleton	ネクロスケルトン
TrappedSoul	囚われし魂
Valkyrie	ワルキューレ
Dopplezon	おとり
Raises Fetishes	フェティッシュを蘇生
Raises Undead	アンデッドを蘇生
Lays Eggs	産卵する
Raises Fallen	フォールンを蘇生
heals Zealots and Cantors	仲間を治す
drains mana and stamina	マナとスタミナを吸収
drains mana	マナを吸収
drains stamina	スタミナを吸収
stun attack	スタン攻撃
eats and spits corspes	屍を食べて吐く
homing missiles	自動追尾の射弾でマナを吸収
raises Stygian Dolls	スティジアン・ドールを蘇生
raises Soul Killers	ソウルキラーを蘇生
raises Flayers	フレイヤーを蘇生
raises Fetishes	フェティッシュを蘇生
raises Ratmen	ラットマンを蘇生
steals life	ライフを盗む
raises undead	アンデッドを蘇生
raises Dark Ones	ダーク・ワンを蘇生
raises Devilkin	デヴィルキンを蘇生
raises Carvers	カーヴァーを蘇生
raises Fallen	フォールンを蘇生
raises Warped Fallen	ウォープトを蘇生
shocking hit	放電攻撃
uniquextrastrong	剛腕
uniqueextrafast	俊速
uniquecursed	呪い
uniquemagicresistance	魔法耐性
uniquefireenchanted	火炎効果
monsteruniqueprop1	冷気効果
monsteruniqueprop2	稲妻効果
monsteruniqueprop3	マナ燃焼
monsteruniqueprop4	スペクトラル・ヒット
monsteruniqueprop5	テレポーテーション
monsteruniqueprop6	ストーン・スキン
monsteruniqueprop7	マルチショット
monsteruniqueprop8	アイテムを奪う
monsteruniqueprop9	オーラ効果
This Cow Bites	この牛は人を咬むぞー！
Champion	チャンピオン
minion	手下
Barrel	樽
Lever1	レバー
BarrelEx	爆発する樽
Door	閉じた扉
Portal	ポータル　行先：
ODoor	開いた扉
BlockedDoor	障害物のある扉
LockedDoor	鍵のかかった扉
StoneAlpha	ケルン
StoneBeta	ケルン
StoneDelta	ケルン
StoneGamma	ケルン
StoneLambda	ケルン
StoneTheta	ケルン
Crate	木枠
Casket	棺
Cabinet	飾り棚
Vase	花瓶
Inifuss	イニファスの樹
corpse	屍
RogueCorpse	ローグ兵の死体
CorpseOnStick	ローグ兵の死体
TowerTome	古びた書
Gibbet	ケインの拷問台
MummyGenerator	ミイラの石棺
ArmorStand	防具立て
WeaponRack	武器ラック
Sarcophagus	石棺
Trap Door	トラップドア
LargeUrn	大壷
CanopicJar	カノープスの壷
Obelisk	オベリスク
HoleAnim	あばかれていない墓
Shrine	ほこら
Urn	壷
Waypoint	中継点
Well	井戸
bag	袋
Chest	箱
chest	箱
lockedchest	鍵のかかった箱
HorazonsJournal	ホラゾンの日誌
templeshrine	ほこら
stair	階段
coffin	棺
bookshelf	本棚
loose boulder	揺らぐ石
loose rock	揺らぐ岩
hollow log	朽ち木
hiding spot	隠し場所
fire	火
Chest3	箱
hidden stash	秘密の隠し場所
GuardCorpse	衛兵の屍
bowl	碗
jug	水差し
AmbientSound	周囲の音
ratnest	ネズミの巣
burning body	燃える死体
well	井戸
door	扉
skeleton	骸骨
skullpile	頭蓋骨の山
cocoon	繭
gidbinn altar	ギドビンの祭壇
cowa	牛
manashrine	ほこら
bed	ベッド
ratchest	箱
blister	水疱
bank	個人用の収納箱
goo pile	汚物の山
holyshrine	聖なるほこら
teleportation pad	テレポートパッド
ratchest-r	ネズミの箱
skull pile	頭蓋骨の山
body	死体
hell bridge	地獄の橋
compellingorb	服従の宝玉
basket	かご
Basket	かご
RockPIle	岩の山
Tome	ホラゾンの日誌
dead body	死体
eunuch	宦官
dead guard	衛兵の屍
portal	ポータル
sarcophagus	石棺
dead villager	村人の屍
sewer lever	下水道のレバー
sewer stairs	下水道の階段
magic shrine	魔法のほこら
wirt's body	ワートの屍
stash	収納箱
guyq	さいなまれし魂
taintedsunaltar	汚された太陽の祭壇
Hellforge	地獄の炉
Corpsefire	コープスファイア
fissure	亀裂
BoneChest	骨の箱
casket	棺
HungSkeleton	吊られた骸骨
pillar	柱
Hydra	ヒュドラ
Turret	小塔
a trap	トラップ
fire	火
cost	費用：
Repair	修理費用：
Sell	売値：
Identify	鑑定費用：
priceless	このアイテムは取引できない
NPCMenuTradeRepair	取引／修理
NPCPurchaseItems	買う
NPCSellItems	売る
NPCHeal	治療：
NPCRepairItems	修理
NPCNextPage	次のページ
NPCPreviousPage	前のページ
strUiMenu2	合成
TransactionMenu1a	あなたのゴールド：
TransactionMenu1f	どのアイテムに魔力を吹き込む？
VerifyTransaction1	はい
VerifyTransaction2	いいえ
VerifyTransaction3	ゴールド：
VerifyTransaction4	売る
VerifyTransaction5	買う
VerifyTransaction6	雇う
VerifyTransaction7	鑑定
VerifyTransaction8	修理
VerifyTransaction9	この者が現在の傭兵と交替する。
TransactionResults1	取引の確認中
TransactionResults2	取引の同期エラー。再試行せよ。
TransactionResults3	無効アイテムあり、プレイヤーダウン。
TransactionResults4	空きスペースが不足している。
TransactionResults5	既に最大数の傭兵を雇っている。
TransactionResults6	そのアイテムは取引したばかりだ。
TransactionResults7	ゴールドを入れるスペースがない。
TransactionResults8	汝はそのアイテムを持っていないはずだ。
TransactionResults9	その要求には応じられない。
TransactionResults10	ゴールドが足りない。
TransactionResults11	彼女は今、来られない。また後で。
ItemDesc1s	手持ち金： %d、どの傭兵を雇うか？
ItemDesc1t	雇える傭兵は残っていない。
HP	ライフ
AC	防御力
Level	Lv
Cost	費用
Damage	ダメージ
strhirespecial1	ファイア・アロー
strhirespecial2	コールド・アロー
strhirespecial3	ジャブ攻撃
strhirespecial4	毒物耐性
strhirespecial5	稲妻
strhirespecial6	冷気
strhirespecial7	火炎
strhirespecial8	稲妻、高速投射
strhirespecial9	冷気、高速投射
strhirespecial10	火炎、高速投射
TalkMenu	話す
WarrivMenu1b	東へ行く
WarrivMenu1c	西へ行く
MeshifMenuEast	東へ航海する
MeshifMenuWest	西へ航海する
NPCMenuNews0	重大ニュース
NPCMenuNews1	緊急ニュース
NPCMenuNews2	切迫事項
NPCMenuNews3	重大ニュース
NPCMenuNews4	緊急事項
NPCMenuTalkMore	もっと聞く
NPCTownMore0	商人について
NPCTownMore1	街の住民
NPCMenuLeave	出発する
NPCGossipMenu	噂
NPCMenuTrade	取引
NPCMenuHire	雇う
gamble	ギャンブル
Intro	自己紹介
Back	キャンセル
ok	ＯＫ
cancel	キャンセル
Continue	続行
strMenuMain15	_
strOptMusic	音楽
strOptSound	サウンド
strOptGamma	コントラスト
strOptRender	レンダー
strOptPrevious	前のメニューへ
cfgCtrl	操作系のコンフィグ（再設定）
merc01	アリザ
merc02	アンプリザ
merc03	アノール
merc04	アバヤ
merc05	エリー
merc06	バクラ
merc07	バサンティ
merc08	ブレイス
merc09	キョウコ
merc10	クロディア
merc11	クンドゥリ
merc12	カイル
merc13	ビサーラ
merc14	エレクサ
merc15	フローリア
merc16	フィオナ
merc17	グウィンニ
merc18	ガイル
merc19	ハンナ
merc20	ヘザー
merc21	イアンサ
merc22	ダミニ
merc23	イゾルデ
merc24	ディボ
merc25	イセラ
merc26	イトニア
merc27	リエネ
merc28	マエコ
merc29	マハラ
merc30	リアザ
merc31	メガン
merc32	オレナ
merc33	オリアナ
merc34	リャン
merc35	ロゼーヌ
merc36	ライサ
merc37	シャリン
merc38	シカ
merc39	スデビ
merc40	ティレナ
merc41	ウェンディ
merclevelup	ずっと強くなった気がする。
Socketable	ソケット
ItemStats1a	要求は未完
ItemStats1b	未鑑定
ItemStats1c	チャージ：
ItemStats1d	耐久力：
ItemStats1e	必要筋力：
ItemStats1f	必要敏捷性： 
ItemStats1g	与えるダメージ：
ItemStats1h	防御力：
ItemStats1i	数量：
ItemStats1j	／
ItemStast1k	-
ItemStats1l	片手持ちダメージ：
ItemStats1m	両手持ちダメージ：
ItemStats1n	投げ攻撃ダメージ：
ItemStats1o	殴打ダメージ：
ItemStats1p	必要レベル：
ItemStats1q	ポイント：
ItemStatsrejuv1	ライフとマナを35％回復
ItemStatsrejuv2	ライフとマナを100％回復
ModStr1a	、筋力上昇
ModStr1b	、敏捷性上昇
ModStr1c	、バイタリティ上昇
ModStr1d	、エネルギー上昇
ModStr1e	、マナ上昇
ModStr1f	、最大ダメージ上昇
ModStr1g	、最小ダメージ上昇
ModStr1h	、攻撃値上昇
ModStr1i	防御力
ModStr1j	火炎耐性
ModStr1k	冷気耐性
ModStr1l	稲妻耐性
ModStr1m	魔法耐性
ModStr1n	毒物耐性
ModStr1o	、最大火炎ダメージ上昇
ModStr1p	、最小火炎ダメージ上昇
ModStr1q	、最大稲妻ダメージ上昇
ModStr1r	、最小稲妻ダメージ上昇
ModStr1s	、最大冷気ダメージ上昇
ModStr1t	、最小冷気ダメージ上昇
ModStr1u	、ライフ上昇
ModStr1v	攻撃者に与えるダメージ：
ModStr1w	のゴールドを追加入手
ModStr1x	、マジックアイテム入手確率が上昇
ModStr1y	跳ね飛ばす
ModStr1z	筋力のエリクサー
ModStr2a	敏捷性のエリクサー
ModStr2b	エネルギーのエリクサー
ModStr2c	バイタリティのエリクサー
ModStr2d	マナのエリクサー
ModStr2e	ライフのエリクサー
ModStr2f	秒間 持続
ModStr2g	最大ライフ 上昇
ModStr2h	最大マナ 上昇
ModStr2i	最大耐久力 上昇
ModStr2j	最大ダメージ強化
ModStr2k	最小ダメージ強化
ModStr2l	ライフを徐々に回復
ModStr2m	マナを徐々に回復
ModStr2n	ライフの1/4を回復
ModStr2o	ライフの1/2を回復
ModStr2p	ライフを完全回復
ModStr2q	マナの1/4を回復
ModStr2r	マナの1/2を回復
ModStr2s	マナを完全回復
ModStr2t	魔法ダメージ低減：
ModStr2u	ダメージ低減：
Modstr2v	防御力強化
ModStr2w	ライフを吸収
ModStr2x	マナを吸収
ModStr2y	のマナを一撃ごとに奪う
ModStr2z	のライフを一撃ごとに奪う
ModStr3a	、アマゾンのスキルレベル上昇
ModStr3b	、パラディンのスキルレベル上昇
ModStr3c	、ネクロマンサーのスキルレベル上昇
ModStr3d	、ソーサレスのスキルレベル上昇
ModStr3e	、バーバリアンのスキルレベル上昇
ModStr3f	 、照明範囲が拡大
ModStr3g	ブロック成功率強化
ModStr3h	必要ステイタス
ModStr3i	、火炎スキル上昇
ModStr3j	攻撃者に与える稲妻ダメージ：
ModStr3k	、全スキル上昇
ModStr3l	ターゲットを凍結
ModStr3m	、敵の傷が開く可能性
ModStr3n	姿を見られない
ModStr3o	ニュートラルの相手に姿を見られない
ModStr3p	マナ回復なし
ModStr3q	ライフ回復なし
ModStr3r	毒物の効果時間を低減、
ModStr3u	命中するとモンスターが逃走
ModStr3v	スタミナ回復：＋
ModStr3w	の損害をマナに変換
ModStr3x	ライフ回復：＋
ModStr3y	ターゲットの防御力を無視
ModStr3z	毒物効果時間を半減
ModStr4a	モンスターの回復を阻止
ModStr4b	凍結効果時間を半減
ModStr4c	のボーナス攻撃値
ModStr4d	ずつ敵の防御力を下げる（命中一回ごとに）
ModStr4e	のダメージをデーモンに与える
ModStr4f	のダメージをアンデッドに与える
ModStr4g	マナを回復させる
ModStr4h	、最大毒物ダメージを強化
ModStr4i	、最小毒ダメージを強化
ModStr4j	、対デーモン攻撃値強化
ModStr4k	、対アンデッド攻撃値強化
ModStr4l	攻撃スピードをやや強化
ModStr4m	攻撃スピード強化
ModStr4n	攻撃スピードを大幅に強化
ModStr4o	速いヒットリカバリー
ModStr4p	より速いヒットリカバリー
ModStr4q	最速のヒットリカバリー
ModStr4r	速い移動
ModStr4s	より速い移動
ModStr4t	最速の移動
ModStr4u	速い呪文詠唱
ModStr4v	より速い呪文詠唱
ModStr4w	最速の呪文詠唱
ModStr4x	素早いブロック
ModStr4y	より素早いブロック
ModStr4z	最速のブロック
ModStr5a	投げ攻撃可能
ModStr5b	ダメージ
ModStr5c	壊滅打のチャンス
ModStr5d	最大スタミナ
ModStr5e	キックダメージ
ModStr5f	マナを、１人倒すごとに得る
ModStr5g	火炎吸収
ModStr5h	火炎吸収
ModStr5i	稲妻吸収
ModStr5j	稲妻吸収
ModStr5k	魔法吸収
ModStr5l	魔法吸収
ModStr5m	冷気吸収
ModStr5n	冷気吸収
ModStr5o	目標の防御力
ModStr5p	残虐性アップ
ModStr5q	致命打
ModStr5r	ターゲットの速度低下、
ModStr5s	ブレスト・エイム
ModStr5t	デファイアンス
ModStr5u	、最大火炎耐性を強化
ModStr5v	、最大冷気耐性を強化
ModStr5w	、最大稲妻耐性を強化
ModStr5x	、最大魔法耐性を強化
ModStr5y	、最大毒物耐性を強化
ModStr5z	凍結されない
ModStr6a	対遠隔防御力
ModStr6b	対近接防御力
ModStr6c	ライフを、デーモンを殺すごとに得る
ModStr6d	命中すると目標は視力を失う
ModStr6e	スタミナ吸収
ModStr6f	、ターゲットを復活させるチャンス
ModStr6g	貫通攻撃
ModStr6h	マジック・アローを発射
ModStr6i	爆発する矢かボルトを発射
strModAllResistances	全耐性 +%d \n
strModAllSkillLevels	+%d、全スキルレベル \n
strModFireDamage	+%d火炎ダメージ \n
strModFireDamageRange	%d-%dの火炎ダメージ追加 \n
strModColdDamage	+%d冷気ダメージ \n
strModColdDamageRange	%d-%dの冷気ダメージ追加 \n
strModLightningDamage	+%d稲妻ダメージ \n
strModLightningDamageRange	%d-%dの稲妻ダメージを追加 \n
strModMagicDamage	+%d魔法ダメージ \n
strModMagicDamageRange	%d-%dの魔法ダメージ追加 \n
strModPoisonDamage	+%d毒ダメージ、%d秒間持続 \n
strModPoisonDamageRange	%d-%dの毒ダメージを追加、%d秒間持続 \n
strModMinDamage	+%dダメージ \n
strModMinDamageRange	%d-%dのダメージ追加 \n
strModEnhancedDamage	強化ダメージ \n
improved damage	ダメージ強化
improved to hit	攻撃値強化
improved armor class	防御力強化
improved durability	耐久力強化
Quick Strike	速攻
strGemPlace1	ソケットの武器または防具に
strGemPlace2	挿入して強化が可能
gemeffect1	兜：筋力を強化 \n盾：盾の防御値を強化 \n武器：攻撃値を強化 \n 
gemeffect2	兜：最大マナを強化 \n盾：冷気耐性を加える \n武器：攻撃に冷気ダメージを追加 \n 
gemeffect3	 兜：敏捷性を強化 \n盾：毒物耐性を加える \n武器：攻撃に毒物ダメージを追加 \n 
gemeffect4	兜：最大ライフを強化 \n盾：火炎耐性を加える \n武器：攻撃に火炎ダメージを追加 \n 
gemeffect5	兜：攻撃値を強化 \n盾：全ての耐性を強化 \n武器：対アンデッドダメージを強化 \n 
gemeffect6	兜：マジックアイテムを見つける確率を強化 \n盾：稲妻耐性を強化 \n武器：攻撃に稲妻ダメージを追加 \n 
gemeffect7	兜：マナとライフの回復力を強化 \n盾：攻撃者に逆にダメージを与える \n武器：攻撃時にマナとライフを盗む \n 
sysmsg1	時間切れによりダウン
sysmsg2	 エラーによりダウン
sysmsg3	%sが我らの世界に加わった。ディアブロの手下も強くなる
sysmsg4	%sは我らの世界を去った。ディアブロの手下は弱くなる
sysmsg3a	%s(%s)が我らの世界に加わった。ディアブロの手下も強くなる
sysmsg4a	%s(%s)は我らの世界を去った。ディアブロの手下は弱くなる
sysmsg5	はゲーム中にいない
sysmsg6	はログインしていない
sysmsg7	は倒された。相手は
sysmsg8	は倒された。相手は
sysmsg9	は殺された
sysmsg10	宝石の種類が違います
sysmsg11	システムは%d分で停止する
sysmsg12	は、あなたの話を聞いてない
sysmsgPlayer	プレイヤー
chatmsg1	のささやき：
chatmsg2	の叫び：
chatmsg3	（レベル
chatmsg3	 )
strwhisperworked	\grey;あなたは\red;%s\grey;にささやいた： %s
syswork	うまくいっている...
ShrId0	効力のないほこら
ShrId1	充填のほこら
ShrId2	健康のほこら
ShrId3	マナのほこら
ShrId4	健康交換のほこら
ShrId5	マナ交換のほこら
ShrId6	アーマーのほこら
ShrId7	戦闘のほこら
ShrId8	火炎耐性のほこら
ShrId9	冷気耐性のほこら
ShrId10	稲妻耐性のほこら
ShrId11	毒物耐性のほこら
ShrId12	スキルのほこら
ShrId13	マナ回復力のほこら
ShrId14	スタミナのほこら
ShrId15	経験のほこら
ShrId16	イナースのほこら
ShrId17	ポータルのほこら
ShrId18	宝石のほこら
ShrId19	火のほこら
ShrId20	魔物のほこら
ShrId21	爆発のほこら
ShrId22	毒のほこら
ShrMsg0	何も感じない
ShrMsg1	気分がすっきりした
ShrMsg2	傷が癒えた
ShrMsg3	英気を養った
ShrMsg4	たいへん気分が良い 
ShrMsg5	エネルギーが満ちてきた
ShrMsg6	皮膚が固くなったようだ
ShrMsg7	戦意が高まった
ShrMsg8	もはや火炎など恐れない
ShrMsg9	もはや冷気など恐れない
ShrMsg10	もはや稲妻など恐れない
ShrMsg11	もはや毒物など恐れない
ShrMsg12	腕前が上がったように感じる
ShrMsg13	精神力がみるみる回復する
ShrMsg14	あらゆる物が軽く感じる
ShrMsg15	経験から多くを学べそうだ
ShrMsg16	ちょっと人が変わったようだ
ShrMsg17	帰る道が開く
ShrMsg18	みごとな宝石だ
ShrMsg19	灼熱の死が広がる
ShrMsg20	死神の代理人が迫る
ShrMsg21	炎の輪が広がる
ShrMsg22	死の輪が広がる
strqi1	ケルンの輪を起動する
strqi2	順序はこの通り
stsa1q3alert	ホラドリック・マリュスは修道院に返された
stsa1q4alert	イニファスの巻物は樹に戻された
stsa3q1alert	ディアブロの手下がラム・エセンの書を取り戻した
qstsa1qt	町の住民
qstsa1qt0	自己紹介
qstsa1q0	第１章プロローグ
qstsa1q1	邪悪の巣窟
qstsa1q2	教団の墓地
qstsa1q3	商売道具
qstsa1q4	ケイン探索
qstsa1q5	忘れられし塔
qstsa1q6	聖堂の殺戮者
strplaylast	スピーチ
newquestlog	新たなエントリー
qsts	クエストの状態
noactivequest	現在、クエストはない
qstsxxx	無効クエスト値
qstsnull	無効状態
qstsComplete	このクエストは終了した。
qstsother	このクエストは他のプレイヤーが既 に終了したため、本ゲームでは終了で きない。
qstsprevious	このクエストは、以前の冒険で終了 している。
qstsThankYouComeAgain	本ゲームではこのクエストを終了で きない。新たなゲームを作成せよ。
qstsThankYouComeAgainMulti	本ゲームではこのクエストを終了できない。新たにゲームを作るか、別のゲームに参加せよ。
qstsThankYouComeAgainSingle	本ゲームではこのクエストを終了できない。ケインは汝の助けを借りずに救出された。
Qstsyouarenot8	このクエストを終了するにはレベル８以上でなければならない。レベル８以上の状態で、新しいゲームを作成するか、別のゲームに参加して終了せよ。
qstsa1q3x	マリュスを持つ人物がゲームから 抜けた。
qstsa1q4x	ホラドリムの巻物を持つ人物がゲ ームから抜けた。
qstsa1q11	ローグ族のキャンプの外の荒野で、 邪悪の巣窟を探せ。
qstsa1q12	邪悪の巣窟のモンスターを一掃せよ
qstsa1q13	
qstsa1q14	モンスター残数：
qstsa1q140	モンスターは残り１匹
qstsa1q15	アカラに会い、報酬を受け取れ。
qstsa1q21	荒涼の平原の奥の、教団の墓地にい るブラッド・レイヴンを探せ。
qstsa1q22	ブラッド・レイヴンを殺せ。
qstsa1q23	カシャに会って報酬を受け取れ。
qstsa1q41	地下通路を通って暗き森に行き、 イニファスの樹を探し、巻物を取れ。
qstsa1q42	イニファスの巻物をアカラに届けよ。
qstsa1q43	岩の原の、ケルンの輪に行け。 イニファスの巻物に記された順番 で石に触れよ。そして赤いポー タルに入れ。ただし、危険は覚悟 せよ。
qstsa1q44	デッカード・ケインを探して救出せよ。
qstsa1q45	ケインはすでに救出され、ローグ族 のキャンプにいる。
qstsa1q46	ローグ族のキャンプの、ケインとアカラを訪ねよ。
qstsa1q46b	アカラと話して報酬を受け取れ。
qstsa1q51	暗き森の彼方、黒き湿地帯に行き、 塔の残骸を探せ。
qstsa1q51a	塔の廃墟の地下ダンジョンを探索せよ。
qstsa1q51b	塔の廃墟の地下ダンジョンを探索せよ。
qstsa1q52	邪悪なる伯爵夫人を討ち取れ。
qstsa1q31	修道院内部を探索し、兵舎に入って ホラドリック・マリュスを取れ。番人の「鍛冶師」には気をつけよ。
qstsa1q32	ホラドリック・マリュスをチャルシに返せ。
qstsa1q32b	チャルシがアイテムに魔法の力を吹き込んでくれる。
qstsa1q61	修道院のカタコンベの奥にある、アンダリエルの本拠を見つけよ。
qstsa1q62	アンダリエルを殺せ。
qstsa1q62b	ワリヴに会い、キャラバンとともに東へ向かえ。
qstsa1q63	ワリヴに会い、キャラバンとともに東へ向かえ。
KeyNone	なし
KeyLButton	マウス1
KeyRButton	マウス2
KeyCancel	キャンセル
KeyMButton	マウス3
Key4Button	マウス4
Key5Button	マウス5
KeyWheelUp	マウスホィールを上に回す
KeyWheelDown	マウスホィールを下に回す
KeyKana	カナ
KeyJunja	Junja
KeyFinal	最終
KeyKanji	漢字
KeyEscape	Esc
KeyConvert	変換
KeyNonConvert	無変換
KeyAccept	決定
KeyModeChange	モード変更
KeyLeft	左
KeyUp	上
KeyRight	右
KeyDown	下
KeySelect	選択
KeyExecute	実行
KeyLWin	左ウィンドウ
KeyRWin	右ウィンドウ
KeyApps	Appsメニュー
KeyNumLock	Num Lock
KeyBack	Backspace
KeyTab	Tab
KeyClear	Clear
KeyReturn	Enter
KeyShift	Shift
KeyControl	Ctrl
KeyMenu	Alt
KeyPause	Pause
KeyCapital	Caps Lock
KeySpace	Space
KeyPrior	Page Up
KeyNext	Page Down
KeyEnd	End
KeyHome	Home
KeyPrint	P - Tell Ken
KeySnapshot	Print Screen
KeyInsert	Insert
KeyDelete	Delete
KeyHelp	Help
KeyNumPad0	Num Pad 0
KeyNumPad1	Num Pad 1
KeyNumPad2	Num Pad 2
KeyNumPad3	Num Pad 3
KeyNumPad4	Num Pad 4
KeyNumPad5	Num Pad 5
KeyNumPad6	Num Pad 6
KeyNumPad7	Num Pad 7
KeyNumPad8	Num Pad 8
KeyNumPad9	Num Pad 9
KeyMultiply	Num Pad *
KeyAdd	Num Pad +
KeySeparator	Separator
KeySubtract	Num Pad -
KeyDecimal	Num Pad .
KeyDivide	Num Pad /
KeyF1	F1
KeyF2	F2
KeyF3	F3
KeyF4	F4
KeyF5	F5
KeyF6	F6
KeyF7	F7
KeyF8	F8
KeyF9	F9
KeyF10	F10
KeyF11	F11
KeyF12	F12
KeyF13	F13
KeyF14	F14
KeyF15	F15
KeyF16	F16
KeyF17	F17
KeyF18	F18
KeyF19	F19
KeyF20	F20
KeyF21	F21
KeyF22	F22
KeyF23	F23
KeyF24	F24
KeyScroll	Scroll Lock
KeySemicolon	;
KeyEqual	=
KeyComma	,
KeyMinus	-
KeyPeriod	.
KeySlash	/
KeyTilde	-
KeyLBracket	[
KeyBackslash	\
KeyRBracket	]
KeyApostrophe	'
ShorthandKeyMButton	m3
ShorthandKey4Button	m4
ShorthandKey5Button	m5
ShorthandKeyWheelUp	mwu
ShorthandKeyWheelDown	mwd
ShorthandKeyKana	kna
ShorthandKeyJunja	jun
ShorthandKeyFinal	fin
ShorthandKeyKanji	kji
ShorthandKeyEscape	esc
ShorthandKeyConvert	con
ShorthandKeyNonConvert	ncn
ShorthandKeyAccept	acc
ShorthandKeyModeChange	mdc
ShorthandKeyLeft	lft
ShorthandKeyRight	rgt
ShorthandKeyDown	Dwn
ShorthandKeySelect	Slt
ShorthandKeyExecute	exc
ShorthandKeyLeftWindows	lwn
ShorthandKeyRightWindows	rwn
ShorthandKeyApps	apm
ShorthandKeyNumLock	nml
ShorthandKeyBackspace	bks
ShorthandKeyClear	clr
ShorthandKeyEnter	ent
ShorthandKeyShift	sft
ShorthandKeyControl	ctl
ShorthandKeyPause	pse
ShorthandKeyCapsLock	clk
ShorthandKeySpace	spc
ShorthandKeyPageUp	pup
ShorthandKeyPageDown	pdn
ShorthandKeyHome	hme
ShorthandKeyPrintScreen	psn
ShorthandKeyInsert	ins
ShorthandKeyDelete	del
ShorthandKeyHelp	hel
ShorthandKeyNumPad0	np0
ShorthandKeyNumPad1	np1
ShorthandKeyNumPad2	np2
ShorthandKeyNumPad3	np3
ShorthandKeyNumPad4	np4
ShorthandKeyNumPad5	np5
ShorthandKeyNumPad6	np6
ShorthandKeyNumPad7	np7
ShorthandKeyNumPad8	np8
ShorthandKeyNumPad9	np9
ShorthandKeyNumPad*	np*
ShorthandKeyNumPad+	np+
ShorthandKeyNumPad-	np-
ShorthandKeyNumPad.	np.
ShorthandKeyNumPad/	np/
ShorthandKeyScroll	slk
KeyMacOption	オプション
KeyMacCommand	コマンド
KeyMacNumPad=	数字パッド＝
ShorthandKeyMacOption	Opt
ShorthandKeyMacCommand	Cmd
ShorthandKeyMacNumPad=	NP=
CfgFunction	機能
CfgPrimaryKey	キー／ボタン1
CfgSecondaryKey	キー／ボタン2
CfgCharacter	キャラクター能力画面
CfgInventory	所持品画面
CfgParty	パーティー画面
CfgMessageLog	メッセージログ
CfgQuestLog	クエストログ
CfgChat	チャット
CfgAutoMap	オートマップ ON／OFF
CfgAutoMapCenter	オートマップを自分中心に
CfgMiniMap	マイクロマップ
CfgHelp	ヘルプ画面
CfgSkillTree	スキルツリー
CfgSkillPick	スキル・スピードバー
CfgSkill1	スキル1
CfgSkill2	スキル2
CfgSkill3	スキル3
CfgSkill4	スキル4
CfgSkill5	スキル5
CfgSkill6	スキル6
CfgSkill7	スキル7
CfgSkill8	スキル8
Cfgskillup	前のスキルを選択する
Cfgskilldown	次のスキルを選択する
CfgBeltShow	ベルトを開く
CfgBelt1	ベルト１を使う
CfgBelt2	ベルト2を使う
CfgBelt3	ベルト3を使う
CfgBelt4	ベルト4を使う
CfgBelt5	ベルト5を使う
CfgBelt6	ベルト6を使う
CfgBelt7	ベルト7を使う
CfgBelt8	ベルト8を使う
CfgBelt9	ベルト9を使う
CfgBelt10	ベルト10を使う
CfgBelt11	ベルト11を使う
CfgBelt12	ベルト12を使う
CfgSay0	「加勢を！」と言う
CfgSay1	「こっちへ！」と言う
CfgSay2	「あげよう。」と言う
CfgSay3	「どうも。」と言う
CfgSay4	「失礼。」と言う
CfgSay5	「じゃ。」と言う
CfgSay6	「死ね！」と言う
CfgRun	走る
CfgRunLock	走る／歩くを切り換える
CfgStandStill	その場に立つ
CfgShowItems	地面のアイテム名を表示
CfgClearScreen	クリアスクリーン
CfgSnapshot	スクリーンショット
CfgDefault	デフォルト
CfgAccept	決定
CfgCancel	キャンセル
strNoKeysAssigned	操作キーの設定は変更されていません。
KeysAssigned	割当てキー
CantAssignMB	これはマウスボタンに割当てられない
CantAssignMW	これはマウスの動きに割当てられない
CantAssignKey	このキーには割当てられない
CfgClearKey	クリアキー
Cfgcleartextmsg	メッセージを消す
CfgTogglePortraits	味方の肖像画を表示／消す
CfgAutoMapFade	オートマップを薄くする
CfgAutoMapNames	オートマップの名前表示
CfgAutoMapParty	オートマップのパーティ表示
strlvlup	新たなステイタス
strnewskl	新たなスキル
warpsheader	ワープ
nowarps	ワープなし
waypointsheader	目的地を選べ
nowaypoints	他に起動している中継点はない
max	MAX
MAX	MAX
colorcode	yc
space	 
dash	-
colon	:
newline	 \n
pipe	|
slash	/
percent	%
plus	+
to	 
srostertitle	プレイヤー
dwell	休止
larva	幼虫
Barbarian	バーバリアン
Paladin	パラディン
Necromancer	ネクロマンサー
Sorceress	ソーサレス
Amazon	アマゾン
druidstr 	ドルイド
assassinstr	アサシン
Nest	巣
NoParty	パーティーなし
ItsMyParty	パーティー＃
Upgrade	吹き込む
upgraderestrict	マジックアイテム、ソケットアイテム、レアアイテム、ユニークアイテム、セットアイテムは不可。宝石や投げ武器も不可。
Use	宝石を使う
NPCIdentify1	アイテムを鑑定
NPCIdentify2	アイテムを鑑定：
strCannotDoThisToUnknown	未鑑定のアイテムを修理することはできない。
Body Looted	略奪された死体
Party1	が、自分の屍から物を取ることを汝に許すと言っている
Party2	が、自分の屍から物を取ることを汝に許すと言っている
Party3	が、汝に敵意を示している
Party4	は、もはや敵意を抱いていない
Party5	が、協力して悪に対抗しようと誘っている
Party6	は、パーティ参加の誘いをキャンセルした
Party7	は、汝のパーティに加わった
Party8	汝の協力者は、
Party9	 は、汝のパーティを去った
strDropGoldHowMuch	ゴールドをいくら落とす？
strDropGoldInfo	ゴールドを落とす
strMsgLog	メッセージログ
strBSArmor	防具
strBSWeapons	武器
strBSMagic	魔法
strBSMisc	その他
strTrade	取引
strTradeAccept	取引を受け入れる
strTradeAgreeTo	取引を開始する
strWaitingForOtherPlayer	相手の返事を待っている
strTradeBusy	は忙しい
strTradeTooFull	汝らの一人は物を持ちすぎている
strTradeGoldHowMuch	ゴールドをいくら提示するか？
strTradeTimeout	そのプレイヤーと取引するには少し待たねばならない。
SysmsgPlayer1	 : 
strBankGoldDeposit	ゴールドをいくら預けるか？
strBankGoldWithdraw	ゴールドをいくら引き出すか？
GoldMax	最大ゴールド：%d
StrUI0	ゴーレム
StrUI1	スケルトン
StrUI2	メイジ
StrUI3	リバイブ
StrUI4	ワルキューレ
strchrlvl	レベル
strchrexp	経験値
strchrnxtlvl	次のレベル
strchrstr	筋力
strchrskm	ダメージ
strchrdex	敏捷性
strchratr	%s \n攻撃値
strchrdef	防御
strchrrat	%s \n値
strchrvit	バイタリティ
strchrstm	スタミナ  
strchrlif	ライフ  
strchreng	エネルギー
strchrman	マナ   
strchrfir	火炎耐性
strchrcol	冷気耐性
strchrlit	稲妻耐性
strchrpos	毒物耐性
strchrstat	
strchrrema	残りポイント
WeaponDescMace	メイス級
WeaponDescAxe	アックス級
WeaponDescSword	ソード級
WeaponDescDagger	ダガー級
WeaponDescThrownPotion	投げ装備
WeaponDescJavelin	ジャベリン級
WeaponDescSpear	スピア級
WeaponDescBow	ボウ級
WeaponDescStaff	スタッフ級
WeaponDescPoleArm	ポールアーム級
WeaponDescCrossBow	クロスボウ級
WeaponAttackFastest	最速の攻撃スピード
WeaponAttackVeryFast	非常に速い攻撃スピード
WeaponAttackFast	速い攻撃スピード
WeaponAttackNormal	標準の攻撃スピード
WeaponAttackSlow	おそい攻撃スピード
WeaponAttackVerySlow	非常におそい攻撃スピード
WeaponAttackSlowest	最もおそい攻撃スピード
strNecromanerOnly	（ネクロマンサーのみ）
strPaladinOnly	（パラディンのみ）
strSorceressOnly	（ソーサレスのみ）
strMaceSpecialDamage	ダメージを、アンデッドに与える
strGoldLabel	ゴールド
strParty1	あなたのパーティーに加わるよう
strParty2	このプレイヤーを誘う
strParty3	このプレイヤーの
strParty4	パーティーに加わる
strParty5	このプレイヤーへの
strParty6	誘いをキャンセルする
strParty7	クリックすれば
strParty8	このプレイヤーと敵対
strParty9	クリックすれば
strParty10	このプレイヤーと中立に
strParty11	クリックすればこのプレイヤーに
strParty12	あなたの死体から物を取ることを許す
strParty13	クリックすればこのプレイヤーに
strParty14	あなたの死体から物を取ることを禁止する
strParty15	クリックすればこのプレイヤーに
strParty16	あなたの話を聞くことを許す
strParty17	クリックすればこのプレイヤーに
strParty18	あなたの話を聞くことをやめさせる
strParty19	クリックすればこのプレイヤーの話を無視
strParty22	クリックすればこのプレイヤーへの無視を解除
strParty24	パーティーから抜ける
strParty25	町の中でなければならない
StrParty26	敵対するには、両プレイヤーとも
StrParty27	レベル９以上でなければならない
strGoldWithdraw	引き出す
strGoldDrop	ゴールドを落とす
strGoldDeposit	預ける
strGoldTrade	提示する
strGoldInStash	収納箱の金：
strGoldTradepup	ゴールドを提示する
strUiMenu1	キャンセル
strUiMenu2	取引に合意
strUiBank	取引に合意
strUnknownTomb	真の墓所は隠されている
strTradeOtherBox	は、この箱にアイテムを入れている
strTradeBox	汝は自分の箱にアイテムを入れている
strFree	、無料であげよう
act1	第１章
act2	第２章
act3	第３章
act4	第４章
level	レベル
lowercasecancel	キャンセル
close	閉じる
strClose	閉じる
Lightning Spell	稲妻の呪文
Fire Spell	火炎の呪文
Cold Spell	冷気の呪文
Yourparty	あなたのパーティ
Inparty	同一パーティ
Invite	招待
Accept	承諾
Leave	去る
Partyclose	閉める
partycharama	アマゾン
partycharsor	ソーサレス
partycharbar	バーバリアン
partycharnec	ネクロマンサー
partycharpal	パラディン
charavghit	平均ヒット率
charmonster	レベル %dの敵に対し： %d%%
charmontohit1	レベル %dの敵の
charmontohit2	あなたへの平均ヒット率：%d%%
panelexp	経験： %u / %u
panelstamina	スタミナ： %u / %u
panelhealth	ライフ: %u / %u
panelmana	マナ: %u / %u
panelmini	ミニパネルを開く
panelcmini	ミニパネルを閉じる
minipanelchar	キャラクター
minipanelinv	所持品
minipaneltree	スキルツリー
minipanelparty	パーティ画面
minipanelautomap	オートマップ
minipanelmessage	メッセージログ
minipanelquest	クエストログ
minipanelmenubtn	ゲームメニュー(Esc)
minipanelHelp	ヘルプ
minipanelspecial	 (%s)
RunOn	走る
RunOff	歩く
automapgame	ゲーム：
automappw	パスワード：
automapdif	難易度：%s
scrollbooktext	数量: %d
skilldesc1	レベル
skilldesc2	パーセント
skilldesc3	必要レベル：
skilldesc4	数量
strpanel1	キャラ情報
strpanel2	クエスト
strpanel3	未使用
strpanel4	所持品
strpanel5	メニュー
strpanel6	オートマップ
strpanel7	未使用
strpanel8	スキルツリー
stashfull	汝の収納箱は一杯だ
Strhelp1	ディアブロIIヘルプ
StrHelp2	<%s>を押しながら移動すれば走る
StrHelp3	<%s>を押しつづければ落ちているアイテム名を表示
StrHelp4	<%s>を押し続ければその場に立って攻撃
StrHelp5	<%s>を押せば、オートマップのオン・オフを切り換え
StrHelp6	<Esc>を押せばゲームメニューを開く
StrHelp7	<Enter>を押せばチャットモードに入る
StrHelp8	 F1からF8に、よく使うスキルを割り振れる
StrHelp8a	<%s>を押せば、この画面を開閉
StrHelp9	ライフ・オーブ
StrHelp10	左マウスボタンで
StrHelp11	実行するスキル
StrHelp12	（クリックして選択できる）
StrHelp13	右マウスボタンで
StrHelp14	走る／歩くを
StrHelp14a	切り換える
StrHelp15	スタミナバー
StrHelp16	経験値
StrHelp16a	バー
StrHelp17	ミニパネル
StrHelp18	（キャラクター能力、
StrHelp19	所持品その他の
StrHelp20	画面を開く）
StrHelp21	ベルト
StrHelp22	マナ・オーブ
strSklTree	
StrSklTreea	スキル群 1
StrSklTreeb	スキル群 2
StrSklTreec	スキル群 3
StrSklTree1	スキル
StrSklTree2	選択
StrSklTree3	残り
StrSklTree4	スキル
StrSklTree5	呪文
StrSklTree6	ジャベリンと
StrSklTree7	スピアの
StrSklTree8	パッシブと
StrSklTree9	魔術の
StrSklTree10	弓と
StrSklTree11	クロスボウの
StrSklTree12	防御の
StrSklTree13	オーラ
StrSklTree14	攻撃の
StrSklTree15	戦闘の
StrSklTree16	召喚
StrSklTree17	毒物と
StrSklTree18	骨の
StrSklTree19	呪い
StrSklTree20	雄叫び
StrSklTree21	戦闘の
StrSklTree22	極意
StrSklTree23	冷気
StrSklTree24	稲妻
StrSklTree25	火炎
StrSkill0	
StrSkill1	次のレベル
StrSkill2	現在のスキル レベル：
StrSkill3	消費マナ：
StrSkill4	ダメージ：
StrSkill5	火炎ダメージ：
StrSkill6	冷気ダメージ：
StrSkill7	稲妻ダメージ：
StrSkill8	毒ダメージ：
StrSkill9	本の矢
StrSkill10	攻撃値：
StrSkill11	ヒット
StrSkill12	-
StrSkill13	冷気効果時間：
StrSkill14	毒汚染時間：
StrSkill15	秒
StrSkill16	秒
StrSkill17	最初のレベル
StrSkill18	半径：
StrSkill19	スクエア
StrSkill20	持続時間：
StrSkill21	防御値：
StrSkill22	攻撃値：
StrSkill23	パーセント
StrSkill24	パーセントの確率
StrSkill25	敵の防御値：
StrSkill26	ヤード
StrSkill27	個の球電を放射
StrSkill28	本の歯を発射
StrSkill29	凍結時間：
StrSkill30	攻撃値ボーナス：
StrSkill31	防御値ボーナス：
StrSkill32	火炎ダメージ：
StrSkill33	ダメージ：敵の現在のライフの：
StrSkill34	（1秒あたり）
StrSkill35	持続する火炎ダメージ
StrSkill36	ヤード
StrSkill37	受けるダメージ：
StrSkill38	敵のダメージ：
StrSkill39	魔法ダメージ：
StrSkill40	吸収
StrSkill41	ダメージ
StrSkill42	ライフ：
StrSkill43	遠隔攻撃ダメージ強化
StrSkill44	体のスケルトン
StrSkill43	体のスケルトンメイジ
StrSkill44	体のスケルトンメイジ
StrSkill45	ゴーレム レベル：
StrSkill46	パーセント（死体のライフの）
StrSkill47	のダメージを自ら受ける
StrSkill48	スタン時間：
StrSkill49	パーセントのシールド力
StrSkill50	回復：
StrSkill51	火災耐性：
StrSkill52	冷気耐性：
StrSkill53	稲妻耐性：
StrSkill54	全耐性：
StrSkill55	パーセントのダメージを返す
StrSkill56	射程：
StrSkill57	敵の攻撃値：
StrSkill58	逃走距離：
StrSkill59	持続時間：
StrSkill60	修正
StrSkill61	3ヒット
StrSkill62	凍結持続時間：
StrSkill63	持続時間
StrSkill64	毒ダメージ
StrSkill65	武器耐久力消耗：+
StrSkill66	標的が殺到：
StrSkill67	敵の射弾速度：- 
StrSkill68	平均
StrSkill69	スタミナ回復率：
StrSkill70	速度：
StrSkill71	最大スタミナ：
StrSkill72	
StrSkill73	個のチャージド・ボルトを放つ
StrSkill74	持続時間：- 
StrSkill75	自然魔法ダメージ：
StrSkill76	行動を中断されない確率
StrSkill77	敵の行動スピード：- 
StrSkill78	狙い続ける
StrSkill79	パーセント（与えたダメージの）
StrSkill80	奪ったダメージの
StrSkill81	パーセントを術者のライフに変える
StrSkill82	火炎の持続時間：
StrSkill83	火炎の爆発ダメージ：
StrSkill84	ライトニングボルトのダメージ：
StrSkill85	呪い持続時間が低下：
StrSkill86	攻撃目標：
StrSkill87	標的
StrSkill88	マナ回復率：
StrSkill89	移動速度：
StrSkill90	耐性：
StrSkill91	ホーリーボルトのダメージ：
StrSkill92	マナを、よろめくごとに
StrSkill94	体のスケルトン
StrSkill95	スケルトン
StrSkill96	メイジ：
StrSkill97	モンスター
StrSkill98	最大耐性：- 
StrSkill99	改宗確率：
StrSkill100	最大ライフ：+ 
StrSkill101	最大マナ：+ 
StrSkill102	最大スタミナ：+ 
StrSkill103	パーセント（火炎ダメージの）
StrSkill104	体のモンスター
StrSkill105	体のモンスター
StrSkill106	攻撃速度：
StrSkill107	ライフ/マナの回復：
StrSkill108	ポイント
StrSkill109	吸収成功確率：
StrSkill110	ブロック成功率：
StrSkill111	（ヤードあたり）
StrSkill112	棘ダメージ
StrSkill113	ヒュドラの火炎ダメージ：
StrSkill114	総合自然ダメージ耐性：
StrSkill115	施術に必要な最小マナ：
StrSkill116	最大レベル
StrSkill117	（アイテム）
StrSkill118	このスキルは、アイテムの機能で獲得
StrSkill119	このスキルはまだ習得していない。
skillname0	攻撃
skillsd0	通常攻撃
skillld0	通常攻撃
skillan0	攻撃
skillname1	キック
skillsd1	キック目標
skillld1	キック目標
skillan1	キック目標
skillname2	投げる
skillsd2	装備したアイテムを投げる
skillld2	装備したアイテムを投げる
skillan2	投げる
skillname3	召喚解除
skillsd3	召喚した怪物を解放する
skillld3	指定した怪物を破棄
skillan3	召喚解除
skillname4	左手投げ
skillsd4	左手のアイテムを投げる
skillld4	左手のアイテムを投げる
skillan4	左投げ
skillname5	左手振り
skillsd5	左手の武器を振る
skillld5	左手の武器を振る
skillan5	左振り
skillname6	マジック・アロー
skillsd6	魔法の矢を作る
skillld6	追加ダメージを与える \n魔法の矢またはボルトを作り
skillan6	マジック・アロー
skillname7	ファイア・アロー
skillsd7	魔法で矢に炎を帯びさせる
skillld7	常にヒット \n炎を帯びさせる \n矢かボルトに魔法をかけ
skillan7	ファイア・アロー
skillname8	インナー・サイト
skillsd8	近くのモンスターを照らし、弱くする
skillld8	ヒットしやすくする \n自分と味方の攻撃を \n付近の敵を照らして
skillan8	インナー・サイト
skillname9	クリティカル・ストライク
skillsd9	パッシブ - 倍のダメージを与える可能性が生まれる
skillld9	パッシブ - 倍のダメージを与える可能性が生まれる
skillan9	クリティカルストライク
skillname10	ジャブ
skillsd10	突き刺す武器で連続攻撃
skillld10	素早い突きを何度も繰り出す \nジャベリンまたはスピア級の武器を使って
skillan10	ジャブ
skillname11	コールド・アロー
skillsd11	矢に冷気魔法をかけ、敵の動きを鈍らせる
skillld11	常にヒット \n冷気の矢のダメージは通常の半分 \n冷気ダメージを与え動きを鈍らせる \n矢やボルトに魔法をかけ
skillan11	コールド・アロー
skillname12	マルチプル・ショット
skillsd12	複数の矢を放つ
skillld12	魔法で何本にもする \n1本の矢またはボルトを
skillan12	Ｍ・ショット
skillname13	ドッジ
skillsd13	パッシブ - 近接攻撃をよける
skillld13	回避する可能性が生まれる \n敵の近接攻撃を \nパッシブ - 移動していない時に
skillan13	ドッジ
skillname14	パワー・ストライク
skillsd14	稲妻ダメージを追加
skillld14	稲妻ダメージを追加 \nジャベリン級とスピア級の攻撃に
skillan14	パワーストライク
skillname15	ポイズンジャベリン
skillsd15	毒ダメージを追加
skillld15	毒の煙をたなびかせる \nジャベリンに魔法をかけ
skillan15	ポイズンジャベリン
skillname16	エクスプローディング・アロー
skillsd16	矢に魔法をかけて爆発させる
skillld16	常にヒット \n爆発させ、付近の敵にダメージを与える \n矢やボルトに魔法をかけて命中時に
skillan16	 Ex・アロー
skillname17	スロー・ミサイル
skillsd17	敵の遠隔攻撃をおそくする
skillld17	付近の敵を照らし、敵の遠隔攻撃の射弾をおそくする
skillan17	スロー・ミサイル
skillname18	アボイド
skillsd18	パッシブ - 射弾を避ける
skillld18	敵の遠隔攻撃を回避する可能性が生まれる \nパッシブ - 移動していない時
skillan18	アボイド
skillname19	インペイル
skillsd19	ダメージが増すが武器が傷む
skillld19	攻撃ダメージが増すが武器の損傷が大きい
skillan19	インペイル
skillname20	ライトニング・ボルト
skillsd20	投げたジャベリンを雷に変える
skillld20	魔法で、投げたジャベリンを雷に変える
skillan20	ライトニングボルト
skillname21	アイス・アロー
skillsd21	矢に魔法をかけて敵を凍らせる
skillld21	常にヒット \n敵を凍結させる \n矢やボルトに魔法をかけ
skillan21	アイス・アロー
skillname22	ガイデッド・アロー
skillsd22	矢に魔法をかけて敵を追わせる
skillld22	常にヒット \n探させたりする \n敵を追跡させたり \n矢やボルトに魔法をかけ
skillan22	ガイデッドアロー
skillname23	ペネトレイト
skillsd23	パッシブ - 遠隔攻撃の攻撃値が上昇
skillld23	パッシブ - 遠隔攻撃の攻撃値が上昇
skillan23	ペネトレイト
skillname24	チャージド・ストライク
skillsd24	突き刺す武器に、稲妻ダメージを付加
skillld24	命中時に稲妻ダメージを起こす \nジャベリン級やスピア級の武器を帯電させ
skillan24	Ｃ・ストライク
skillname25	プラーグ・ジャベリン
skillsd25	ジャベリンに魔法をかけ、毒を散布させる
skillld25	命中時に毒の煙を発生させる \nジャベリンに毒ダメージを追加し
skillan25	プラーグ・Ｊ
skillname26	ストレイフ
skillsd26	矢に魔法をかけ、複数の目標を攻撃する
skillld26	複数の敵を攻撃 \n1本の矢を魔法で分割し
skillan26	ストレイフ
skillname27	イモレイション・アロー
skillsd27	矢が爆裂し、地面を燃やす
skillld27	常にヒット \n着弾時には燃え上がる \n強い火炎ダメージを追加し \n矢やボルトに魔法をかけて
skillan27	イモレイションＡ
skillname28	デコイ
skillsd28	自分の偽物を作る
skillld28	敵の攻撃を分散させる \n自分の偽物を作り
skillan28	おとり
skillname29	イベイド
skillsd29	パッシブ - 移動時に回避
skillld29	よける可能性が生まれる \n敵の近接／遠隔攻撃を \nパッシブ - 移動中に
skillan29	イベイド
skillname30	フェンド
skillsd30	隣接するすべての目標を攻撃
skillld30	隣接するすべての目標を短時間で攻撃
skillan30	フェンド
skillname31	フリージング・アロー
skillsd31	矢に魔法をかけて複数のモンスターを凍らせる
skillld31	常にヒット \n複数のモンスターを凍らせる \n矢やボルトに魔法をかけ
skillan31	フリージングＡ
skillname32	ワルキューレ
skillsd32	神の使いの女戦士を召喚する
skillld32	神の使いの女戦士を召喚する
skillan32	ワルキューレ
skillname33	ピアース
skillsd33	パッシブ - 射弾が複数の敵を貫通
skillld33	進む可能性が生まれる \nパッシブ - 射弾が複数の敵を貫いて
skillan33	ピアース
skillname34	ライトニングストライク
skillsd34	突き刺す武器から稲妻が走る
skillld34	命中時には火花が走り複数の敵を襲う \nジャベリン級とスピア級の武器に稲妻ダメージを追加し
skillan34	Ｌ・ストライク
skillname35	ライトニング・フューリー
skillsd35	着弾後にライトニング・ボルトが拡散
skillld35	着弾時には地面を稲妻が走る \n投げたジャベリンを雷に変化させ
skillan35	Ｌ・フューリー
skillname36	ファイア・ボルト
skillsd36	魔法の火の玉を飛ばす
skillld36	魔法の火の玉を飛ばす
skillan36	ファイア・ボルト
skillname37	ウォームス
skillsd37	パッシブ - マナ回復率が上昇
skillld37	パッシブ - 大気を暖め、消費したマナを早く回復させる
skillan37	ウォームス
skillname38	チャージド・ボルト
skillsd38	複数の稲妻を発射する
skillld38	小さな稲妻を発射 \n複数の、ジグザグに進む
skillan38	チャージド・ボルト
skillname39	アイス・ボルト
skillsd39	氷を発射し敵の動きを鈍らせる
skillld39	敵にダメージを与え動きを鈍らせる \n魔法の氷塊を発射して
skillan39	アイス・ボルト
skillname40	フローズンアーマー
skillsd40	防御を強化し、攻撃してくる敵を凍らせる
skillld40	攻撃してくる敵を凍らせる \n氷をまとって防御値を上げ、
skillan40	Ｆ・アーマー
skillname41	インフェルノ
skillsd41	激しい火炎放射
skillld41	敵を焼き払う \n激しい炎を連続放射し
skillan41	インフェルノ
skillname42	スタティックフィールド
skillsd42	一定範囲に激しい放電を発生させる
skillld42	付近の敵全員の体力を1/3奪う \n激しい放電を発生させ
skillan42	Ｓ・フィールド
skillname43	テレキネシス
skillsd43	意思で物体を動かす
skillld43	敵をよろめかせたりできる \nアイテムを拾ったり物を使ったり \n意思の力を使って
skillan43	テレキネシス
skillname44	フロスト・ノヴァ
skillsd44	超低温の輪を広げる
skillld44	付近の敵全員にダメージを与えて動きを鈍らせる \n自分を中心に超低温の輪を広げ、
skillan44	フロスト・ノヴァ
skillname45	アイス・ブラスト
skillsd45	氷を発射し敵を凍りつかせる
skillld45	敵にダメージを与え凍らせる \n魔法の氷塊を発射し
skillan45	アイス・ブラスト
skillname46	ブレイズ
skillsd46	通った跡に火を燃え上がらせる
skillld46	触れた敵を焼き殺す \n自分の通った跡に炎の壁を残し
skillan46	ブレイズ
skillname47	ファイア・ボール
skillsd47	爆発する火球を発射
skillld47	爆発して被害が広がる \n火球を発射すると、着弾後に
skillan47	ファイア・ボール
skillname48	ノヴァ
skillsd48	電撃の輪を広げる
skillld48	付近の敵を感電させる \n自分を中心に電撃の輪を広げて
skillan48	ノヴァ
skillname49	ライトニング
skillsd49	直進する稲妻を放射
skillld49	敵をなぎ払う \n直進する強力な稲妻で
skillan49	ライトニング
skillname50	シヴァー・アーマー
skillsd50	敵を凍らせダメージを与える
skillld50	攻撃してきた敵を凍らせダメージを与える \n防御値を上昇させ
skillan50	シヴァーアーマー
skillname51	ファイア・ウォール
skillsd51	炎の壁を発生させる
skillld51	敵を阻み、焼き殺す \n炎の壁を発生させて
skillan51	ファイアウォール
skillname52	エンチャント
skillsd52	味方の武器に火炎の魔法を追加
skillld52	遠隔武器なら以下の1/3の火炎ダメージを追加 \n近接武器なら以下の火炎ダメージを、 \n味方の武器に魔法をかける
skillan52	エンチャント
skillname53	チェイン・ライトニング
skillsd53	屈曲し複数の敵を撃つ稲妻
skillld53	複数の標的を貫く \n発射した稲妻が屈曲し
skillan53	Ｃ・ライトニング
skillname54	テレポート
skillsd54	瞬時に目的地に移動する
skillld54	見えている場所に瞬時に移動する
skillan54	テレポート
skillname55	グラシアル・スパイク
skillsd55	超低温で爆発する氷の砲弾を発射
skillld55	付近の敵を凍結させ大損害を与える \n氷の砲弾を発射、着弾時に爆発して
skillan55	Ｇ・スパイク
skillname56	メテオ
skillsd56	天から流星を呼び寄せる
skillld56	指定した地点を粉砕し焼き払う \n天から流星を呼び寄せ
skillan56	メテオ
skillname57	サンダー・ストーム
skillsd57	強力な雷雲を呼び出す
skillld57	敵を稲妻で打たせる \n頭上に雷雲を呼び寄せ
skillan57	サンダーストーム
skillname58	エナジー・シールド
skillsd58	マナを消費して敵の攻撃を吸収
skillld58	ライフの代わりにマナを消費する \n魔法のシールドで敵の攻撃を吸収し
skillan58	エナジーシールド
skillname59	ブリザード
skillsd59	猛吹雪を呼び寄せる
skillld59	雪雲を呼び寄せ、指定地点の付近に猛吹雪を発生させる
skillan59	ブリザード
skillname60	チリング・アーマー
skillsd60	遠隔攻撃に自動的に反撃
skillld60	自動的に反撃する \n防御値を上げ、遠隔攻撃には
skillan60	チリングアーマー
skillsname61	ファイア・マスタリー
skillsd61	パッシブ - 火炎ダメージを上げる
skillld61	パッシブ - すべての火炎魔法の威力が上昇
skillan61	ファイアマスタリー
skillname62	ヒュドラ
skillsd62	多頭の火炎怪獣を召喚
skillld62	敵を焼き殺させる \n多頭の火炎怪獣を呼び出し
skillan62	ヒュドラ
skillname63	ライトニング・マスタリー
skillsd63	パッシブ - 稲妻魔法の消費マナを減らす
skillld63	消費するマナを減らす \nパッシブ - 稲妻魔法を使う際に
skillan63	ライトニングマスタリー
skillname64	フローズン・オーブ
skillsd64	氷の刃を放射する超低温の球体を発射
skillld64	敵に大損害を与える \n超低温の球体が飛びながら氷の刃をまき散らし
skillan64	フローズンオーブ
skillname65	コールド・マスタリー
skillsd65	パッシブ - 敵の冷気耐性を低下させる
skillld65	ダメージを増大させる \nパッシブ - 敵の冷気耐性を低下させ
skillan65	コールドマスタリー
skillname66	アンプリファイ・ダメージ
skillsd66	呪い - 敵が受けるダメージを増幅
skillld66	魔法以外で受ける損害を増す \n敵の一群を呪い
skillan66	アンプリファイ
skillname67	ティース
skillsd67	ドラゴンの歯を発射
skillld67	ドラゴンの歯を召喚して発射
skillan67	ティース
skillname68	ボーン・アーマー
skillsd68	近接戦闘ダメージを吸収させる
skillld68	近接戦闘ダメージを吸収させる \n召喚した骨を自分の周囲で回転させ
skillan68	ボーン・アーマー
skillname69	スケルトン・マスタリー
skillsd69	パッシブ - 蘇らせたスケルトンや怪物の能力向上
skillld69	ライフや攻撃力が増す \nパッシブ - 蘇らせたスケルトンや怪物の
skillan69	スケルトンマスタリー
skillname70	レイズ・スケルトン
skillsd70	敵の死体から骸骨戦士を作る
skillld70	骸骨戦士を作って加勢させる \n倒した敵の死体から
skillan70	レイズスケルトン
skillname71	ディム・ビジョン
skillsd71	呪い - モンスターの視力を低下させる
skillld71	視覚範囲を減らす \n指定した範囲の敵全員を呪い
skillan71	ディム・ビジョン
skillname72	ウィークン
skillsd72	呪い - 敵の攻撃力を低下させる
skillld72	攻撃の威力を低下させる \n敵のグループに呪いをかけ
skillan72	ウィークン
skillname73	ポイズン・ダガー
skillsd73	ダガー攻撃に毒の効果を追加
skillld73	ダガー攻撃に毒の効果を追加
skillan73	ポイズン・ダガー
skillname74	コープス・エクスプロージョン
skillsd74	敵の死体を爆弾に変える
skillld74	周囲の敵に毒物ダメージを与える \n敵の死体を爆発させ、
skillan74	コープス・Ｅｘ
skillname75	クレイ・ゴーレム
skillsd75	粘土のゴーレムを作り味方にする
skillld75	戦いに加勢させる \n土からゴーレムを作り
skillan75	クレイ・ゴーレム
skillname76	アイアン・メイデン
skillsd76	呪い - 敵は、攻撃で与えたダメージを自らも受ける
skillld76	攻撃と同時に自分の身を傷つけさせる \n敵のグループに呪いをかけ
skillan76	アイアンメイデン
skillname77	テラー
skillsd77	呪い - モンスターが恐怖で逃げる
skillld77	恐怖で逃走させる \n敵のグループを呪い、
skillan77	テラー
skillname78	ボーン・ウォール
skillsd78	骨の壁で道をふさぐ
skillld78	敵の通行を止める \n骨の壁を築いて
skillan78	ボーン・ウォール
skillname79	ゴーレム・マスタリー
skillsd79	ゴーレムの早さとライフが向上
skillld79	すべてのゴーレムの移動速度とライフが向上する
skillan79	ゴーレムマスタリー
skillname80	レイズ・スケルトン・メイジ
skillsd80	敵の死体から骸骨魔道師を作る
skillld80	戦いに加勢させる \n敵の死体から骸骨魔道師を作り
skillan80	スケルトンメイジ
skillname81	コンフューズ
skillsd81	呪い - 敵の攻撃目標がランダムになる
skillld81	敵に呪いをかけ、攻撃目標を混乱させる
skillan81	コンフューズ
skillname82	ライフ・タップ
skillsd82	呪い - 敵からライフを奪えるようにする
skillld82	ダメージを与えた者はライフを得る \n一群の敵を呪い、彼らに
skillan82	ライフ・タップ
skillname83	ポイズン・エクスプロージョン
skillsd83	死体を毒ガス爆弾に変える
skillld83	付近の怪物にダメージを与える \n毒ガス爆弾に変えて \n敵の死体に魔法をかけ、
skillan83	ポイズン・Ｅｘ
skillname84	ボーン・スピア
skillsd84	骨のスパイクを発射
skillld84	敵を貫通する骨のスパイクを発射
skillan84	ボーン・スピア
skillname85	ブラッド・ゴーレム
skillsd85	ライフとダメージを共有するゴーレム
skillld85	ダメージも共有する \n血のゴーレム。敵のライフを奪って術者に送るが
skillan85	ブラッドゴーレム
skillname86	アトラクト
skillsd86	呪い - 敵の１体を全怪物に狙わせる
skillld86	加えて他の呪いをかけることはできない \n付近の全怪物がその敵を襲う。 \n敵の１体を呪うと
skillan86	アトラクト
skillname87	ディクレピファイ
skillsd87	呪い - 敵を大幅に鈍く、弱くする
skillld87	大幅に鈍く、弱くする \n敵のグループに呪いをかけて
skillan87	ディクレピファイ
skillname88	ボーン・プリズン
skillsd88	敵の周りに骨の囲いを作る
skillld88	敵一体の周りに骨の囲いを作って閉じこめる
skillan88	ボーン・プリズン
skillname89	サモン・レジスト
skillsd89	パッシブ - 召喚したモンスターが耐性を得る
skillld89	各種の耐性を与える \nパッシブ - 召喚した全怪物に
skillan89	サモン・レジスト
skillname90	アイアン・ゴーレム
skillsd90	金属アイテムからゴーレムを作る
skillld90	ゴーレムはアイテムの性質を受け継ぐ \n金属アイテムからゴーレムを作る。
skillan90	アイアンゴーレム
skillname91	ロウアー・レジスト
skillsd91	呪い - 敵の魔法耐性を下げる
skillld91	呪い - 敵の魔法耐性を下げる
skillan91	ロウアー・レジスト
skillname92	ポイズン・ノヴァ
skillsd92	自分を中心に毒の輪を広げる
skillld92	自分を中心に毒の輪を広げる
skillan92	ポイズン・ノヴァ
skillname93	ボーン・スピリット
skillsd93	亡霊を召喚し発射
skillld93	敵を探索、追尾し自動的に命中する \n苦悶する亡霊が
skillan93	ボーン・スピリット
skillname94	ファイア・ゴーレム
skillsd94	炎のゴーレムを作る
skillld94	敵の火炎攻撃からライフを得るゴーレム \n付近の敵に火炎ダメージを与え、
skillan94	ファイアゴーレム
skillname95	リバイブ
skillsd95	怪物を生き返らせ、味方にする
skillld95	味方として戦わせる \n殺した敵を生き返らせて
skillan95	リバイブ
skillname96	サクリファイス
skillsd96	攻撃精度とダメージ向上
skillld96	攻撃精度とダメージを向上させる \n自分のライフを削って
skillan96	サクリファイス
skillname97	スマイト
skillsd97	盾で敵を殴る
skillld97	スタン（くらくら）させる \n盾で敵を殴って
skillan97	スマイト
skillname98	マイト
skillsd98	オーラ - 攻撃力向上
skillld98	攻撃ダメージが上昇 \nオーラ - 自分と味方の
skillan98	マイト
skillname99	プレイアー
skillsd99	オーラ - ライフ回復
skillld99	徐々に回復させる \nオーラ - 自分と味方のライフを
skillan99	プレイアー
skillname100	レジスト・ファイア
skillsd100	オーラ - 火炎ダメージを低減
skillld100	火炎ダメージを低減 \nオーラ - 自分と味方の受ける
skillan100	レジストファイア
skillname101	ホーリー・ボルト
skillsd101	アンデッドにダメージを与える光球
skillld101	味方の傷を治す \nアンデッドにダメージを与え、 \n神聖な光球を発射して
skillan101	ホーリー・ボルト
skillname102	ホーリー・ファイア
skillsd102	オーラ - 付近の敵に火炎ダメージを与える
skillld102	オーラ - 付近の敵に火炎ダメージを与える
skillan102	ホーリーファイア
skillname103	ソーンズ
skillsd103	オーラ - 敵にダメージを返す
skillld103	オーラ - 敵にダメージを返す
skillan103	ソーンズ
skillname104	ディファイアンス
skillsd104	オーラ - 防御力上昇
skillld104	オーラ - 自分と味方の防御力が上昇
skillan104	ディファイアンス
skillname105	レジスト・コールド
skillsd105	オーラ - 冷気ダメージを低減
skillld105	オーラ - 自分と味方の冷気ダメージを低減
skillan105	レジストコールド
skillname106	ジール
skillsd106	隣接する複数の敵を一気に攻撃
skillld106	隣接する複数の敵を一気に攻撃
skillan106	ジール
skillname107	チャージ
skillsd107	目標に突撃する
skillld107	目標に突撃し大きなダメージを与える
skillan107	チャージ
skillname108	ブレスト・エイム
skillsd108	オーラ - 攻撃値上昇
skillld108	オーラ - 自分と味方の攻撃値が上昇
skillan108	ブレスト・エイム
skillname109	クレンジング
skillsd109	オーラ - 毒と呪いの持続時間を低減
skillld109	持続時間を低減 \nオーラ - 自分と味方の、毒と呪いの
skillan109	クレンジング
skillname110	レジスト・ライトニング
skillsd110	オーラ - 稲妻ダメージを低減
skillld110	オーラ - 自分と味方の受ける稲妻ダメージを低減
skillan110	レジスト・Ｌ
skillname111	ヴェンジャンス
skillsd111	攻撃に自然魔法ダメージを追加
skillld111	魔法ダメージを追加 \n攻撃に火炎、稲妻、冷気の
skillan111	ヴェンジャンス
skillname112	ブレスト・ハンマー
skillsd112	渦巻き状に飛ぶ魔法のハンマーを召喚
skillld112	対アンデッドはダメージ150% \n自分を中心に渦巻き状に飛ばす。 \n天界のハンマーを召喚し
skillan112	ブレストハンマー
skillname113	コンセントレイション
skillsd113	オーラ - 攻撃能力上昇
skillld113	行動を中断されない確率が発生 \n敵の攻撃を受けても \nオーラ - 攻撃の威力が増し、
skillan113	コンセントレイト
skillname114	ホーリー・フリーズ
skillsd114	オーラ - 冷気で付近の敵を鈍らせる
skillld114	オーラ - 冷気で付近の敵の動きを鈍らせる
skillan114	ホーリーフリーズ
skillname115	ヴィガー
skillsd115	オーラ - 移動速度とスタミナ回復率が上昇
skillld115	自分と味方の移動速度とスタミナ回復率が上昇
skillan115	ヴィガー
skillname116	コンヴァージョン
skillsd116	敵を一時的に改心させる
skillld116	周囲の怪物と戦わせる \n敵を一時的に改心させ
skillan116	コンヴァージョン
skillname117	ホーリー・シールド
skillsd117	盾を増強する
skillld117	神の力で盾を増強する
skillan117	ホーリーシールド
skillname118	ホーリー・ショック
skillsd118	オーラ - 付近の敵に稲妻ダメージを与える
skillld118	オーラ - 付近の敵を感電させ稲妻ダメージを与える
skillan118	ホーリーショック
skillname119	サンクチュアリ
skillsd119	オーラ - アンデッドにダメージを与え、はね飛ばす
skillld119	はね飛ばす \nオーラでアンデッドにダメージを与え、
skillan119	サンクチュアリ
skillname120	メディテイション
skillsd120	オーラ - マナ回復率上昇
skillld120	オーラ - 自分と味方のマナ回復率上昇
skillan120	メディテイション
skillname121	フィスト・オヴ・ザ・ヘヴンズ
skillsd121	天罰。空から雷が落ちる
skillld121	ホーリー・ボルトが拡散する \n強力な落雷が目標を撃ち、その後
skillan121	Ｆ・ヘヴンズ
skillname122	ファナティシズム
skillsd122	オーラ - 攻撃速度と攻撃値上昇
skillld122	オーラ - 自分と味方の攻撃速度と攻撃値が上昇
skillan122	ァナティシズム
skillname123	コンヴィクション
skillsd123	オーラ - 敵の防御能力低下
skillld123	オーラ - 周囲の敵の防御値と耐性を下げる
skillan123	コンヴィクション
skillname124	リデンプション
skillsd124	オーラ - 敵の死体からライフとマナを吸収
skillld124	徐々に回復する \n自分と味方のライフとマナが \n敵の死体に近づくと
skillan124	リデンプション
skillname125	サルヴェイジョン
skillsd125	オーラ - 自然魔法で受けるダメージを低減
skillld125	攻撃で受けるダメージを低減 \n自分と味方が火炎、冷気、稲妻の
skillan125	サルヴェイジョン
skillname126	バッシュ
skillsd126	力強い一撃で与えるダメージが上昇
skillld126	敵をはね飛ばす \n力強い一撃で与えるダメージが上昇し
skillan126	バッシュ
skillname127	ソード・マスタリー
skillsd127	パッシブ - ソードの技が上達
skillld127	パッシブ - ソードの技が上達
skillan127	ソードマスタリー
skillname128	アックス・マスタリー
skillsd128	パッシブ - アックスの技が上達
skillld128	パッシブ - アックスの技が上達
skillan128	アックスマスタリー
skillname129	メイス・マスタリー
skillsd129	パッシブ - メイスの技が上達
skillld129	パッシブ - メイスの技が上達
skillan129	メイスマスタリー
skillname130	ハウル
skillsd130	付近のモンスターをおびえさせる
skillld130	逃走させる \n付近の敵をおびえさせ
skillan130	ハウル
skillname131	ファインド・ポーション
skillsd131	敵の死体からポーションを発見
skillld131	ポーション発見のチャンスがある \n敵の死体を指定して使うと
skillan131	Ｆ・ポーション
skillname132	リープ
skillsd132	敵や障害物を飛び越す
skillld132	あるいは乱戦に飛び込む \n跳躍して危険から逃れ、、
skillan132	リープ
skillname133	ダブル・スイング
skillsd133	両手の武器を一気に振り回す
skillld133	またはひとつの目標を２回攻撃 \n２つの目標を次々と攻撃するか、 \n両手の武器で、短時間に
skillan133	ダブル・スイング
skillname134	ポールアーム・マスタリー
skillsd134	パッシブ - ポールアームの技が上達
skillld134	パッシブ - ポールアームの技が上達
skillan134	ポールアームマスタリー
skillname135	スローイング・マスタリー
skillsd135	パッシブ - 投げる技術の上達
skillld135	パッシブ - 投げる技術の上達
skillan135	スローイングマスタリー
skillname136	スピア・マスタリー
skillsd136	パッシブ - スピアの技が上達
skillld136	パッシブ - スピアの技が上達
skillan136	スピアマスタリー
skillname137	トーント
skillsd137	敵を怒らせて不用意な攻撃をさせる
skillld137	敵を挑発し、怒らせて不用意な攻撃をさせる
skillan137	トーント
skillname138	シャウト
skillsd138	仲間に注意し警戒させる
skillld138	自分と味方の防御値を上げる \n迫る危険を警告し
skillan138	シャウト
skillname139	スタン
skillsd139	敵をくらくらさせる
skillld139	攻撃値を上昇させる \n猛烈な一撃で敵をくらくらさせ
skillan139	スタン
skillname140	ダブル・スロー
skillsd140	素早く２つの武器を投げる
skillld140	短時間に素早く投げる \n両手に装備した投げ用武器を
skillan140	ダブル・スロー
skillname141	スタミナ増進
skillsd141	パッシブ - スタミナを増強する
skillld141	パッシブ - 最大スタミナが増大する
skillan141	Ｉ・スタミナ
skillname142	ファインド・アイテム
skillsd142	敵の死体からアイテムを発見する
skillld142	アイテムが見つかる場合がある \n敵の死体から
skillan142	Ｆ・アイテム
skillname143	リープ・アタック
skillsd143	ジャンプして目的地付近の敵を攻撃する
skillld143	着地後に強烈な一撃 \n目標までジャンプして
skillan143	リープ・アタック
skillname144	コンセントレイト
skillsd144	攻撃動作が中断されない
skillld144	攻撃値と防御値も上昇 \n敵の攻撃を受けても自分の攻撃動作が中断せず、
skillan144	コンセントレイト
skillname145	アイアン・スキン
skillsd145	パッシブ - 防御値が上昇
skillld145	パッシブ - 防御値が上昇
skillan145	アイアン・スキン
skillname146	バトル・クライ
skillsd146	敵の戦闘効率を下げる
skillld146	敵の防御値と攻撃力を下げる \n恐ろしい叫びを発して
skillan146	バトル・クライ
skillname147	フレンジー
skillsd147	ダブルスイングが命中すると速度が増す
skillld147	あらゆる行為のスピードが増す \n攻撃が成功するたびに \n両手に持った別の武器を一気に使え、
skillan147	フレンジー
skillname148	インクリースト・スピード
skillsd148	パッシブ - 移動速度が増す
skillld148	パッシブ - 歩く速度、走る速度が増す
skillan148	Ｉ・スピード
skillname149	バトル・オーダー
skillsd149	味方の最大ライフ、マナ、スタミナが上昇
skillld149	最大スタミナが上昇 \n自分と味方の最大ライフ、最大マナ、
skillan149	バトル・オーダー
skillname150	グリム・ウォード
skillsd150	恐ろしい塔を作って敵をおどす
skillld150	敵をおびえさせ逃亡させる \n恐ろしい塔を作って \n敵の死体から
skillan150	グリム・ウォード
skillname151	ワールウィンド
skillsd151	武器を振り回しながら突き進む
skillld151	立ちふさがる敵を粉砕する \n激しく回転して進み \n武器を振り回しながら
skillan151	ワールウィンド
skillname152	バーサーク
skillsd152	強力だが無謀な攻撃をしかける
skillld152	防御値は低下 \n攻撃値と与えるダメージは上がるが \n強力だが無謀な攻撃。
skillan152	バーサーク
skillname153	ナチュラル・レジスタンス
skillsd153	パッシブ - 火炎、冷気、稲妻、毒への耐性
skillld153	および毒への耐性が上昇 \nパッシブ - 火炎、冷気、稲妻、
skillan153	Ｎ・レジスタンス
skillname154	ウォー・クライ
skillsd154	絶叫で付近の敵を傷つけスタンさせる
skillld154	付近の敵にダメージを与え、スタン（くらくら）させる
skillan154	ウォー・クライ
skillname155	バトル・コマンド
skillsd155	スキル・レベル上昇
skillld155	自分と味方の持つ全スキルのレベルを上昇
skillan155	バトル・コマンド
skillname217	鑑定の巻物
skillsd217	マジックアイテムの性質を鑑定する
skillld217	マジックアイテムの性質を鑑定する
skillan217	鑑定
skillname218	鑑定の書
skillsd218	マジックアイテムの性質を鑑定する
skillld218	マジックアイテムの性質を鑑定する
skillan218	鑑定
skillname219	タウン・ポータルの巻物
skillsd219	最も近い町へ魔法の門を開く
skillld219	最も近い町へ魔法の門を開く
skillan219	タウン・ポータル
skillname220	タウン・ポータルの書
skillsd220	最も近い町へ魔法の門を開く
skillld220	最も近い町へ魔法の門を開く
skillan220	タウン・ポータル
strMephistoDoorLocked	オーマスがこのドアを開くキーを持っている
strTitleFeminine	Lady %s
strTitleMasculine	Lord %s
strChatHardcore	ハードコア
strChatLevel	レベル %d
Tristram	トリストラム
Catacombs Level 4	カタコンベ レベル４
Catacombs Level 3	カタコンベ レベル３
Catacombs Level 2	カタコンベ レベル２
Catacombs Level 1	カタコンベ レベル１
Cathedral	大聖堂
Inner Cloister	奥の歩廊
Jail Level 3	監獄 レベル３
Jail Level 2	監獄 レベル２
Jail Level 1	監獄 レベル１
Barracks	兵舎
Outer Cloister	表の歩廊
Monastery Gate	修道院の門
Tower Cellar Level 5	塔の地下室 レベル５
Tower Cellar Level 4	塔の地下室 レベル４
Tower Cellar Level 3	塔の地下室 レベル３
Tower Cellar Level 2	塔の地下室 レベル２
Tower Cellar Level 1	塔の地下室 レベル１
Forgotten Tower	忘れられし塔
Mausoleum	霊廟
Crypt	納棺堂
Burial Grounds	墓地
Pit Level 2	穴 レベル２
Hole Level 2	坑道 レベル２
Underground Passage Level 2	地下通路 レベル２
Cave Level 2	洞窟 レベル２
Pit Level 1	穴 レベル１
Hole Level 1	坑道 レベル１
Underground Passage Level 1	地下通路 レベル１
Cave Level 1	洞窟 レベル１
Den of Evil	邪悪の巣窟
Tamoe Highland	タモエ高地
Black Marsh	黒き湿地帯
Dark Wood	暗き森
Stony Field	岩の原
Cold Plains	荒涼の平原
Blood Moor	血の湿原
Rogue Encampment	ローグ族のキャンプ
To Tristram	トリストラムへ
To The Catacombs Level 4	カタコンベ レベル４へ
To The Catacombs Level 3	カタコンベ レベル３へ
To The Catacombs Level 2	カタコンベ レベル２へ
To The Catacombs Level 1	カタコンベ レベル１へ
To The Cathedral	大聖堂へ
To The Inner Cloister	奥の歩廊へ
To The Jail Level 3	監獄 レベル３へ
To The Jail Level 2	監獄 レベル２へ
To The Jail Level 1	監獄 レベル１へ
To The Barracks	兵舎へ
To The Outer Cloister	表の歩廊へ
To The Monastery Gate	修道院の門へ
To The Tower Cellar Level 5	塔の地下室 レベル５へ
To The Tower Cellar Level 4	塔の地下室 レベル４へ
To The Tower Cellar Level 3	塔の地下室 レベル３へ
To The Tower Cellar Level 2	塔の地下室 レベル２へ
To The Tower Cellar Level 1	塔の地下室 レベル１へ
To The Forgotten Tower	忘れられし塔へ
To The Mausoleum	霊廟へ
To The Crypt	納棺堂へ
To The Burial Grounds	墓地へ
To The Pit Level 2	穴 レベル２へ
To The Hole Level 2	坑道 レベル２へ
To Underground Passage Level 2	地下通路 レベル２へ
To The Cave Level 2	洞窟 レベル２へ
To The Pit Level 1	穴 レベル１へ
To The Hole Level 1	坑道 レベル１へ
To Underground Passage Level 1	地下通路 レベル１へ
To The Cave Level 1	洞窟 レベル１へ
To The Den of Evil	邪悪の巣窟へ
To The Tamoe Highland	タモエ高地へ
To The Black Marsh	黒き湿地帯へ
To The Dark Wood	暗き森へ
To The Stony Field	岩の原へ
To The Cold Plains	荒涼の平原へ
To The Blood Moor	血の湿原へ
To The Rogue Encampment	ローグ族のキャンプへ
Deathmessage	死神は%dゴールドの通行料を取った
Deathmessnight	経験値を失った
Harddeathmessage	汝の勇気は忘れぬ
LordofTerrordied	ゲーム終了まで%d秒
Killdiablo1	見事だ！
KillDiablo2	汝はディアブロを討ち取った
KillDiablo3	汝は以下の称号をもって呼ばれる
x	終了
x	OK
x	キャンセル
x	(c) 2000 Blizzard Entertainment
x	All Rights Reserved.
x	シングルプレイヤー
x	BATTLE.NET
x	その他のマルチプレイヤー
x	ディアブロIIを終了
x	クレジット
x	ムービー
x	閲覧可能なムービーをすべて見る
x	エピローグ
x	ムービー選択
x	オープンBATTLE.NET
x	TCP/IP ゲーム
x	TCP/IP オプション
x	ゲームを主催
x	ゲームに参加
x	ゲームに参加するにはホストIPアドレスを入力
x	あなたのIPアドレスは：
x	「ゲームを主催」をクリックして、自分のコンピュータをゲームのホストにします。他のプレイヤーはそのIPアドレスを入力してコンピュータに接続することになります。このゲームでは、自分のマシンに保存したキャラクター以外プレイできません。
x	「ゲームに参加」をクリックして、ホストコンピュータのIPアドレスを入力してください。このゲームでは自分のマシンに保存したキャラクター以外プレイできません。
x	有効なTCP/IPアドレスを検出できません。
x	キャラクター名
x	ハードコア
x	ヒーロークラス選択
x	槍と弓が得意な、万能の女戦士。
x	アンデッドや亡霊を召喚して使い、敵を呪うのも得意。
x	頑健で力が強く、近接戦闘や武器の扱いに卓越。
x	火炎、稲妻、冷気などの自然魔法の達人。
x	生まれつきのリーダーで、信心深い聖戦士。
x	プレイヤーが見つかりません
x	キャンセル
x	チャンネル作成
x	チャンネル参加
x	ゲーム名が無効です
x	同じ名前のゲームがすでに存在します
x	サーバー ダウン
x	ゲーム作成エラー
x	参加失敗
x	最大Battle.Net
x	キャラクターに達しました
x	
x	新たなキャラクターを作成
x	（新規のオープンキャラクター）
x	（新規のレルムキャラクター）
x	ヒーロークラス選択
x	ハードディスクの空き容量が不足しています。マニュアルを参照して必要な容量を確保した上で、再試行してください。
x	ゲーム作成
x	ゲーム参加
x	LANゲーム作成
x	LANゲーム参加
x	Hell
x	Nightmare
x	Normal
x	難易度選択
x	ハードコアとノーマルのキャラクターは同じゲームに入れません。
x	ゲームが存在しません。
x	ゲーム名とパスワードが一致しません。
x	ゲームが満員です。
x	このゲームのレベル制限に合いません。
x	このキャラクターを消去してもよろしいですか。注意：このキャラクターに関わるすべての情報が失われます。
x	オープン
x	そのキャラクター名はすでに使用されています。別の名前を試してください。
x	はい
x	いいえ
x	以下のDiablo II ディスクを挿入してください：
x	Play Disc
x	Cinematics Disc
x	Battle.netに接続中
x	ゲートウェイ問い合わせ中
x	最も速いサーバーに接続中
x	あなたのアカウントにアクセス中
x	バージョンをチェック中
x	CD-key 確認中
x	プレイヤー プロフィール取得中
x	完了
x	パッチのダウンロード中
x	利用者同意書
x	同意する
x	同意しない
x	新しいバージョンのソフトウェアが使用できます。ゲーム プログラムを完全にアンインストールして、オリジナルCDからインストールし直し、Battle.netに接続し直してください。
x	Battle.netに接続できません。モデムを使ってプロバイダにアクセスしていて、かつリモート・アクセスの設定を行っていないなら、手操作で接続の初期化を行う必要が生じる場合があります。
x	インターネット接続が不調か、接続時にポート6112でUDPパケットを処理していないかのいずれかです。チャットはできますが、ゲームはできません。このポートを開くためには、あなたのインターネット・プロバイダ、またはシステム管理者に問い合わせてください。
X	このアプリケーションは、Battle.netで承認されていないCDキーを使ってインストールされています。
x	Battle.netは、あなたのアプリケーションのバージョンを認識できませんでした。
x	よろしければ、以下のサイトを参照ください。（英語版） www.battle.net/support/errormessages/
x	Battle.netに接続できません。
x	モデムを使用しているなら、直接Battle.netに接続を試みる前に、あなたのインターネット・プロバイダに接続する必要があります。詳しくは、www.battle.net/support/errormessages/をご覧ください。
x	あなたは今、インターネット・プロバイダーに16ビットで接続しています。
x	Battle.netでは、インターネット接続に32ビット必要です。現在使用している接続ソフトウェアが、あなたのインターネット・プロバイダの最新版かどうか確認してください。
x	TCP/IP接続を開けません。OpenTransportが正しくインストールされているか確認してください。Battle.netに接続する前に、インターネット・プロバイダーに接続する必要が生じる場合もあります。
x	アプリケーションを一度アンインストールし、CDケースのCDキーを使ってインストールし直してください。それでもBattle.netに接続できない場合は、www.battle.net/support/errormessages/をご覧ください。
x	このソフトウェアの新しいバージョンが出ています。Battle.netでは、常に最新バージョンの使用をお勧めしています。お使いのソフトウェアをアップデートして下さい。
x	アップデートファイルのダウンロードに成功しました。アプリケーションを再起動します。
x	アップデートが中断されたため、更新できませんでした。やり直してください。
x	ソフトウェアのアップグレードファイルをダウンロードしています。
x	インストールに使用したCDキーが無効になっています。詳細は、Blizzard Entertainment Technical Supportにお問い合わせください。
x	そのCDキーを現在使用しているのは：
x	そのＣＤキーは、一度に一台のマシンだけが使用できます。Battle.netへの接続が中断された場合は、5分間待って再接続してください。
x	このアプリケーションをインストールするために使用されたCDキーは、別製品向けになっています。正しいCDキーを使って、このアプリケーションをインストールしなおしてください。
X	現在レルムの更新中です。15分ほど待ってから再びおいでください。
x	Battle.netへログイン
x	既存のBattle.netアカウントを使用するには、下記の情報を入力して「ログイン」をクリックして下さい。新規の方は、「新規アカウント作成」をクリックして下さい。
x	そのアカウント名はすでに存在します
x	入力したパスワードは間違っています。再度入力してください。
x	そのアカウントは存在しません。このアカウントで3ヶ月以上Battle.netに接続していないなら、消去されています。「新規アカウント作成」を選択して新しい名前とパスワードを選択してください。
x	そのアカウントは不正使用されています。至急、support@blizzard.comまでご連絡下さい。
x	サーバー ダウン
x	サーバーに接続できません。
x	サーバー ダウン
x	サーバー認証失敗
x	名前
x	サーバーにより拒否
x	アカウント名は最低2文字です。
x	アカウント名は最大15文字です。
x	パスワードが一致しません。
x	パスワードは最低2文字です。
x	パスワードは最大12文字です。
x	新規アカウント作成
x	Battle.netアカウント作成
x	新しいBattle.netアカウントの名前とパスワードを入力してください。
x	アカウント名
x	パスワード
x	パスワード確認
x	お読み下さい
x	使用しないアカウントは定期的に削除されますのでご注意下さい。新しいアカウントを作成した場合は、作成後48時間以内に、1セッションまたは複数のセッションで合計2時間以上、Battle.netにログインしている必要があります。
x	その後、90日に1回そのアカウントでログインしていれば、アカウントは消えません。
x	パスワードをメモしておいて下さい。BLIZZARDではパスワードを調べることができません。忘れてしまったパスワードを探したり置換したりすることもできません。
x	ユーザー名は最低2文字です。別の名前で再度入力してください。
x	ユーザー名に無効な文字が1文字以上含まれています。
x	ユーザー名に使用不可能な文字が1文字以上含まれています
x	先ほどのアカウント作成要求を現在処理中です。数分間待って、新規作成したアカウントでログインしてみてください。
x	その名前には、英数字が不足しています。
x	その名前には、隣接した句読点文字が多すぎます。
x	名前に句読点文字が多すぎます。
x	入力したパスワードが一致しません。同じパスワードを2回入力してください。
x	選択した名前のアカウントはすでに存在しています。別の名前を入力してください。
x	無効なIDが入力されました。
x	入力したパスワードが間違っています。3か月間 Battle.netを使用していない場合、あるいはパスワードを忘れてしまった場合は、[新しいアカウント]を選択して新しい名前とパスワードを選択して下さい。
x	パスワードを変更することができません。無効な名前またはパスワードを指定しました。
x	お待ちください。
x	ログイン エラー
x	バージョンを識別できません。
x	インストールし直してアップグレードしてください。
x	接続できません。
x	Battle.net
x	アカウントの新規作成ができません。
x	battle.netアカウントを作成して下さい。
x	新しいbattle.netアカウントの名前とパスワードを入力してください。
x	人々
x	フィルター
x	チャンネル
x	プレイヤー
x	パスワード(オプション)
x	ゲーム説明(オプション)
x	最大プレイヤー数:
x	キャラクターレベル差：
x	レベル
x	チャンネルの作成／参加
x	チャンネル名
x	チャンネル
x	はい
x	いいえ
x	プレイヤー プロフィール
x	名前
x	性別
x	年齢
x	現在地
x	説明
x	消去
x	新たなキャラクターを作成
x	ゲーム名
x	ゲーム名とプレイヤー数
x	使用しないキャラクターは定期的に削除されますのでご注意下さい。新しいキャラクターを作成した場合、作成後48時間以内に合計2時間以上使用しないと削除されます。
x	その後、そのキャラクターを少なくとも90日に１回は使用して下さい。使用しなかった場合、そのキャラクターは削除されます。
x	前回のプレイは%d日前です
x	
x	前回のプレイは昨日です
x	%d日以内にプレイしてください。
x	でないとアカウントが消去されます。
x	１日以内にプレイしてください
x	ステイタス不明
x	消去された可能性あり
x	キャラクター消去済み
x	プレイヤー名
x	ログイン
x	レルムを選択して下さい。
x	現在、どのレルムも使用できません。少し待ってやり直してください。
x	下のリストからレルムを選択するか、「レルム名」ボックスに名前を入力して、「OK」をクリックします。
x	レルム名
x	レルムリスト
x	ソート
x	アルファベット順
x	人数
x	レルム情報
x	接続速度：
x	現在の能力：
x	レルムとは、battle.net専用サーバーです。ここに公認キャラクターを保管し、そのキャラクターで公認ゲームを実行できます。ひとりの公認キャラクターは、1つのレルムでしかプレーできません。
x	キャラクター保管サイト
x	公認キャラクターは、ランキングやチャット・ポートレートなど、すべてのbattle.net機能にアクセスできます。公認キャラクターをプレイするには、インターネット接続が必要です。
x	警告：ハードコア・キャラクターが死ぬと、二度と復活しません。ハードコア・キャラクターを作成してよろしいですか。
x	死んだハードコア・キャラクターでゲームを作成、参加することはできません。
x	送信
x	ささやき
x	無視
x	ヘルプ
x	動作
x	無視解除
x	小休止
x	新規作成
x	参加
x	チャンネル
x	ランキング
x	終了
x	標準ランキング
x	ハードコア・ランキング
x	週間ランキング
x	ランク
x	名前
x	クラス
x	取得経験値
x	経験値
x	表示：
x	全体
x	クラス別
x	K
x	M
x	B
x	T
x	%s %sから
x	%s %sに送る
Gem Activated	活性化された宝石
Gem Deactivated	非活性化された宝石
Perfect Gem Activated	活性化された完全な宝石
x	チャンネル名が無効です。チャンネル名に予約済みのキャラクターを含むことはできません。
x	あなたは今、インターネットへのリンクをクリックました。ウェブ ブラウザを起動しています。Battle.netに戻るにはWindowsのタスクバー使用して下さい。
x	Battle.netへの接続を中断しました。OKを押すと%sへの接続を中断します。Cancelを押すと、接続したままになります。
x	Battle.netはあなたの通常使うブラウザを起動できませんでした。
x	このURLは開けませんでした。URLは無効と思われます。
x	Battle.netからウェブ ブラウザを起動するには、Internet Config 1.1以降が必要です。Internet Configがコンピュータにインストールされているか確認してください。
x	Internet Configまたはインターネット コントロール パネルで選択されたあなたの通常使うウェブ ブラウザが、ハードディスクに見つかりませんでした。
x	ウェブ ブラウザを起動するには、空きメモリが不足しています。
x	あなたは今、インターネットへのリンクをクリックしました。ウェブ ブラウザが起動されます。全画面モードのゲームに戻るには、ゲームメニューの「スクリーン モード切替」を使用してください。
x	そのチャンネルはアクセスが制限されています
x	Battle.netとの接続は切断されました。再接続してください。
x	Battle.netがダウンしています。後で接続し直してください。
x	応答待ちでタイムアウトになりました。
x	Battle.netがダウンしています。後で接続し直してください。
x	Battle.netへの接続が切れました。
x	Battle.netへの接続が切れました。
x	Battle.netが応答しません。数分待って再接続してください。
x	Battle.netが応答しません。数分待って再接続してください。
x	Battle.netの接続が中断されました。後で接続し直してください。
x	Battle.netの使用を禁じられました。後で接続し直してください。
x	接続不良が発生しました。
x	このゲームを作成したホストが、ゲームを去りました
x	死んだハードコア・キャラクターでゲームを作成、参加することはできません。
x	バージョンが合致しません。http://www.blizzard.com/support/Diablo2にアクセスし、パッチを入手してください。
x	ゲームに参加できません。ハードコア・キャラクターで、ノーマル・キャラクターの作成したゲームに加わることはできません。
x	ゲームに参加できません。ノーマル・キャラクターで、ハードコア・キャラクターの作成したゲームに加わることはできません。
x	ゲームに参加できません。難易度「Hell（地獄）」のゲームをプレイするには、同じキャラクターで「Nightmare（悪夢）」のディアブロを倒していなければなりません。
x	ゲームに参加できません。難易度「Nightmare（悪夢）」のゲームをプレイするには、同じキャラクターでディアブロを倒していなければなりません。
x	ゲームに参加できません。キャラクターのバージョンが不正です。
x	ゲームに参加できません。キャラクターのクエストデータが不正です。
x	ゲームに参加できません。キャラクターの、中継点のデータが不正です。
x	ゲームに参加できません。キャラクターの、ステイタスのデータが不正です。
x	ゲームに参加できません。キャラクターの、スキルのデータが不正です。
x	ゲームに参加できませんでした。
x	ゲームに参加できません。
x	失敗の理由は不明です。
x	ゲームに参加できません。所持品のデータが不正です。
x	ゲームに参加できません。死体のデータが不正です。
x	ゲームに参加できません。データのヘッダーが不正です。
x	ゲームに参加できません。傭兵のデータが不正です。
x	ゲームに参加できません。NPCの紹介のデータが不正です。
x	ゲームに参加できません。アイテムのデータが不正です。
x	ゲームに参加できません。死体のアイテムのデータが不正です。
x	ゲームに参加できません。不正なファイルが含まれています。
x	ゲームが満員です。
dummy	an evil force
Dummy	an evil force
not used	an evil force
unused	an evil force
Not used	an evil force
convertsto	右クリック
strNotInBeta	betaにありません。
strLevelLoadFailed	レベルネーム不要
Endthispuppy	Beta終了