String Index	Text
A4Q2ExpansionSuccessTyrael	40\n光輝を称えよ！　そなたは不可能を可\n能にしたのだ！\n\nディアブロとメフィストは打ち砕かれ、\nそもそもの故郷である黒き深淵に還っ\nた。汚れしソウルストーンももはやな\nい。\n\nしかれども、そなたがここで戦う間に\nも、バールは地上界に残り地獄の軍勢\nを再編成しておった。そして暗黒の軍\n団はすでに再起を果たし、あらゆるソ\nウルストーンの力の源である秘宝「ワー\nルドストーン」を捜して進軍しておる。\n彼らは各地に破壊の傷跡を刻んだ末、\n今はバーバリアン族の故郷、聖地アリー\nト山の頂上を目指しておるところだ。\n\nよいか勇者よ、バールはもはや知って\nおるぞ。アリート山こそ、ワールドス\nトーンのありかなのだ！\n\n急いで、我の開いたポータルに入るが\nよい。これはバーバリアンの街ハロガ\nスにつながっておる。いまや、アリー\nト山腹のかの街こそが、破壊の軍勢を\n防ぐ最後の砦なのだ！\n
A4Q2ExpansionSuccessCain	40\n君ならやってくれると思っておったよ。\nまったく信じがたい偉業だ。\n\n私はホラドリムの先人と違い、研究の\nみに没頭してきたため戦場には立てな\nかった。しかし、その知識で君という\n勇者を補佐できたなら本望だ。\n\nさあ勇者よ、この地を去ろう。この天\n界軍の砦は驚異ではあるが、しかしこ\nの先ずっと、ここを訪れる必要がない\nことを切に願うよ。\n\n去る前に、ティラエルに挨拶をしてき\nたまえ。\n
AncientsAct5IntroGossip1	33\n我らはネファレムの魂、古き民。この\n聖なるアリートの山嶺にて、ワールド\nストーンを守る者なり。世に勇者と呼\nばるる者は多かれども、真にその名に\n値する武勇を持つ者は少なし。その重\n責を担うに足る者は、さらにまれなり。\n\nこの地に立ち入らんと欲すれば、我ら\nを倒し力を示せ。\n
CainAct5IntroGossip1	38\nこの地は、よく持ちこたえているな。\n破壊の魔王バールの襲撃を受けた他の\n国々は、もっと完膚なきまでに蹂躙さ\nれたというのに。\n\nさすがにバーバリアン族、アリート山\nを守る伝説の戦士と言われるのもうな\nずける。ただし彼らは、誇り高く武骨\nな民族だ。よそ者には慣れておらんだ\nろうから、温かい歓迎は期待できんな。\n\nむしろ私の方が、彼らの信用を得られ\nるかもしれん。なるべく街の人々と交\n流を結んで話を聞きだしてみるから、\n何かわかったら君に伝えよう。\n
CainAct5Gossip1	48\n今さらのようだが、地獄の魔獣と戦う\n際には体の大きさに惑わされるな。人\nの半分ほどの背丈でも恐るべき力を秘\nめていることがあるし、子犬ほどの大\nきさでも虎のように獰猛なものだぞ。\n
CainAct5Gossip2	48\nバーバリアン族は勇猛な戦士として世\nにあまねく知られているが、実は情け\n深い博愛の民族でもある。なにしろ彼\nらは、異民族を含んだ世界全体を守る\nべく、予言に従って有史以来ずっとこ\nの荒野に住まい、厳しい修練を積んで\n備えを固めてきたのだからな。\n
CainAct5Gossip3	45\n太古の昔から、アリートの守り手たち\nは天使ティラエルの降臨をたびたび目\n撃しておるようだ。ティラエルとバー\nルは、ちっぽけな人間の魂などを巡っ\nて争っているのではあるまい。時の始\nめより、相容れぬ存在なのであろうな。\n
CainAct5Gossip4	48\nホラドリムの学府で研究にいそしんで\nいた頃には、よく仲間たちとアリート\n山の意味について議論したものだ。\n\nバーバリアンの諸部族が、我が身を省\nみずにこの聖なる山を守ることは、誰\nでも知っておる。しかし多くの者は、\nその動機を単なる迷信と見なしがちだ。\nバーバリアンは生来野蛮で排他的ゆえ、\n伝説にかこつけて争いを起こしたがる\nのだと言ってな。\n\nたしかに、アリート山の探検に向かっ\nたホラドリムは、残らず消息を絶った。\nしかし私は、彼らがバーバリアンに殺\nされたとは思っておらん。\n
CainAct5Gossip5	40\nかりにも魔術を修める身なら、アリー\nト山の名を知らぬ者はおらんが、しか\nしその真価を知る者は多くはない。こ\nの地は、深遠なる魔力の結節点なのだ。\n\nそしていま、破壊の王がその魔力の源\nを求めて山頂を目指しておるというわ\nけだ。彼がもし目的を果たせばどうな\nるか、考えたくもないな。\n
CainAct5Gossip6	48\n私はいままで何十年もの歳月を費やし\nて、世界の真理を究めようと努めてき\nた。しかしいざ動乱が起きてみると、\n自分の知識がいかに限られたものであっ\nたかを痛感したよ。私にできることが\nあれば、何でも言ってくれ。\n
CainAct5Gossip7	46\nハロガスの長老会は壊滅したが、若い\n者の中にも優秀な人材はおる。たとえ\nばアーニャは、部族を率いるのに充分\nな胆力と叡知を備えておるようだ。もっ\nともすべては、彼らがこの苦境を乗り\n切れればの話になるだろうがな。\n
CainAct5Gossip8	50\nアーニャはまったく、女ゆえの強さの\nよい見本と言うべきだろうな。あの娘\nを見ておると、若い頃に知り合ったザ\nカラムの女司祭たちを思い出すよ。し\nかも彼女らには、純潔の誓いを立てる\n習慣はなかったしな。\n
CainAct5Gossip9	53\nこの街に、ラーザックほどの鍛治屋が\nいたのは幸いだった。彼の腕前は、君\nにとっても大きな助けになるだろう。\n彼ならば、最盛期のホラドリムにでも\n大歓迎されただろうね。\n
CainAct5Gossip10	52\nこの戦いの元になったのはソウルストー\nンだろうと、私はにらんでおる。もし、\nマリウスとかいう愚か者が魔神に惑わ\nされなければ、バールは今でもタル・\nラシャの体に封印されておったはずな\nのだ。\n
AnyaAct5IntroGossip1	53\nどうやらあなたは、勇者と呼ばれるに\nふさわしい力を持っているようね。\n\n見ての通り、今は苦難の時よ。あなた\nの力を借りて、バールを打ち倒せるこ\nとを祈っているわ。\n\nハロガスの長老会は壊滅したわ。私の\n父オーストも、その一員だった。皆が\n絶望に沈まないでいられるのは、バー\nルへの復讐を誓っているおかげよ。\n
AnyaGossip1	50\n長老たちはみんな死んでしまった。彼\nらの叡知なくして、本当にこの暗黒の\n時代を乗り切れるのか、正直言ってわ\nからないわ。父の後を継ぐのは私だけ\nど、私一人で部族全体の運命を担うな\nんて、重すぎる。\n\nでも、私たちは強い民よ。ただ全力を\n尽くして、あとは運命に任せるだけだ\nわ。\n
AnyaGossip2	76\nバールの軍団を甘く見ないことね。連\n中は、敵を倒すためなら喜んで自分の\n命を捨てるんだから。\n
AnyaGossip3	55\nよそ者たちは、私たちの祖先「古き民」\nにまつわる伝説を、ただの作り話と思っ\nているようね。でも私は、古き民は人\n間以上の存在だと信じているわ。人類\nは本来彼らのようだったのに、衰えて\n今のようになったんじゃないかしら。\n
AnyaGossip4	60\n子供の頃から、よく長老たちに聞かさ\nれたわ。あの山に秘められた力の話を。\nそれから、私たちバーバリアンが山の\n守護者として、いかに重要な役目を負っ\nているかを。\n\nバールは単に、私たちの領土を奪って\nいるだけじゃない。魔獣の軍が山に近\nづくごとに、私たちの誇りも、存在意\n義も奪われていくのよ。\n
AnyaGossip5	65\nあなたが助けに駆けつけてくれたこと\nには、本当に感謝しているわ。でも、\n早いうちに近隣諸国に援軍を求めてい\nれば、戦況はもっと明るかったでしょ\nうね。伝説の守護者としての愚かな誇\nりが、判断を誤らせたのよ...。\n
AnyaGossip6	45\n私の父のオーストは、バールの軍に立\nち向かうなら外部に援軍を求めるべき\nだと、最初から主張していたわ。この\n戦いが単なる部族の問題ではなく、世\n界全体の運命にかかわるものだと知っ\nていたのね。人が生きるには水や食べ\n物が必要なように、世界が生きるには\nアリート山の力が必要なんだと、父は\n言っていたわ。私もその通りだと思う。\n
AnyaGossip7	50\n以前のクォル＝ケックは傲慢なほどの\n自信家だったけど、バールと戦って誇\nりを傷つけられたようね。最初の防戦\nで、部下の三分の一を失ってしまった\nから。\n\n兵たちの死に、彼ほど心を痛めている\n人はいないでしょう。本人は認めたが\nらないだろうけど、あなたの存在は彼\nにとっても希望の象徴になっているは\nずよ。\n
AnyaGossip8	67\nラーザックに、鍛冶の腕の半分でも歌\nや踊りの才能があれば、とっくに結婚\nできていたでしょうね。あの盛り上がっ\nた肩を見ればわかるでしょ。\n
AnyaGossip9	53\nニーラサックは長老会の最後の生き残\nりだったわ。彼は彼なりに力を尽くし\nて部族を導き、山を守ろうとしたよう\nだけど、他の皆にも増して状況が見え\nなくなっていたのね。\n\n裏切りは許せないけど、彼の失敗から\n学ぶことはできそうだわ。\n
AnyaGossip10	55\n部族の者は、アリート山を守っている\n「古き民」には、バールを止める力が\nあると信じていたわ。でも、実際に破\n壊の王の猛威を見ていると、なにも信\nじられなくなってしまったけどね。\n
LarzukAct5IntroGossip1	55\n俺はラーザック、鍛治屋をやってる。\n先祖代々、このハロガスじゃ最高の職\n人なんだぜ。\n\nでも最近じゃ材料がどんどん乏しくなっ\nてきてるし、城壁の向こうの魔物ども\nはいっこうに弱る気配がないから、い\nくら頑張っても追っつきゃしねえがな。\n\nそのうち俺も、鍛冶のハンマーを置い\nて剣を持つ日が来るのかもしれねえな。\n
LarzukAct5IntroAmaGossip1	46\nへえ、あんたアマゾンかい。あんたら\nの噂は聞いてるぜ。すごい武器を使う\nそうじゃねえか。俺の作ったのと比べ\nてみるかい？\n\n俺はラーザック、鍛治屋をやってるん\nだ。先祖代々、このハロガスじゃ最高\nの職人なんだぜ。\n\nでも最近じゃ材料がどんどん乏しくなっ\nてきてるし、城壁の向こうの魔物ども\nはいっこうに弱る気配がないから、い\nくら頑張っても追っつきゃしねえがな。\n\nそのうち俺も、鍛冶のハンマーを置い\nて剣を持つ日が来るのかもしれねえな。\n
LarzukGossip1	66\nあんたらアマゾンは、飛び道具の扱い\nがうまいらしいな。たしかに見た限り\nじゃ、地獄のケダモノどもを狩るにゃ、\nそいつが一番良さそうだ。\n\nところであんたらの部族は、みんなそ\nんなに... デカいのかい？\n
LarzukGossip2	63\nいったいぜんたい、どうして住みやす\nい南の島を離れて、こんな寒い戦場に\n来たんだ？　もしこの戦いに生き残れ\nたら、あんたの故郷を案内してくれね\nえか？\n
LarzukGossip3	65\nゆうべは、あの気色悪い遠吠えのせい\nでよく眠れなかったんじゃないのかい？\n何かの獣だって言う奴もいるけどよ、\nあんな声の動物なんて見たことも聞い\nたこともねえぜ。\n
LarzukGossip4	63\n魔物どもの軍団は、俺たちの造った塔\nやバリケードをぶんどって、包囲戦に\n利用してやがる。できれば、奴らが装\n備をととのえる前に包囲網を破ったほ\nうが、賢明ってもんなんだろうがね。\n
LarzukGossip5	65\nニーラサックのヤケクソなホラは、聞\nいてるだけで参っちまうぜ。やせても\n枯れても長老だろうによ。いっそ消え\nてくれた方がせいせいするぐらいだ。\n
LarzukGossip6	63\nこないだ、クォル＝ケックに包囲網を\n破る作戦の案を話したんだが、マトモ\nに聞こうともしやがらねえ。俺が戦士\nじゃないからナメてるのか、それとも\nハナっから俺をバカだと思ってるのか。\nどっちにしてもいけすかねえぜ。\n
LarzukGossip7	53\n言い伝えじゃ、アリート山のてっぺん\nには俺たちの先祖の霊がいて、山を守っ\nてるそうだぜ。俺たちは頂上には登れ\nない掟なんだが、よそ者は何度か登っ\nていったな。ただし、帰ってきた奴は\nいねえけどな。\n
LarzukGossip8	63\nこの街も、戦勝会ともなればにぎやか\nなもんだ。俺たちバーバリアンは子供\nの頃から戦士の修行をするんだが、同\nじぐらい熱心に祭りの稽古もやってる\nからな。\n\nあんた、余分な酒を持ってるなら高く\n買うぜ。\n
LarzukGossip9	52\n俺がこうやって安全な鍛冶場で働いて\nる間にも、城壁の外じゃ毎日友達が死\nんでってるんだ。ここまで武器が不足\nしてるんでなけりゃ、俺だって剣を取っ\nて戦場に出てやりたいんだがな。\n\n俺の分まで、頑張ってくれよ。\n
LarzukGossip10	55\n一応言っとくけど、あんたから取る金\nは一文も稼ぎにゃなってねえんだぜ。\nだいたいは、武器や防具の材料を仕入\nれるので消えちまう。残りは全部、マ\nラーとクォル＝ケックに渡してるんだ。\n必要な物をそろえてもらうためによ。\n
MalahAct5IntroGossip1	39\nわたくしはマラー。アリート山に建つ\n秩序の最後の砦、ハロガスへようこそ。\n破壊の王バールと戦うおつもりでした\nら、ちょうどいいところに来てくださ\nいましたね。\n\n見ての通り、バールはわたくしたちの\n聖なる山を汚し、人々の命を奪いまし\nた。攻撃は今も続いており、クォル＝\nケックの率いる部隊では歯が立ちませ\nん。バールは山で何かを探しているよ\nうなのですけれど、それが何なのかは、\nわたくしにはわかりません。\n\nニーラサックを除く長老会の面々は、\nハロガスを守る結界を張るために、残\nらず命を落としました。\n\nニーラサックをはじめ、あなたの存在\nを快く思わない者もいるようです。我\nらは伝説の戦士であることに誇りを持っ\nておりますから、助けの手を差しのべ\nられることに抵抗があるのですね。し\nかしわたくし個人は、心から感謝して\nいますよ。\n\nヒーリングやポーションが必要なとき\nには、わたくしのところにおいでなさ\nい。武器や防具のことなら、ラーザッ\nクに頼めば大丈夫です。他に足りない\n物があれば、一応はニーラサックにも\n相談した方がいいでしょう。それから\nクォル＝ケックは、ハロガスの軍令長\nとしてバールと戦っている人ですから、\nあなたの力になってくれるかもしれま\nせん。\n
MalahAct5IntroSorGossip1	38\nソーサレスが... このハロガスに？\n\n実はわたくしも昔は、ソーサレスにな\nろうと思ったことがあるのですよ。素\n質がなくて、ものになりませんでした\nけどね。ヒーリングの技だけは磨いて、\nほとんどどんな傷も治せるようになり\nましたけど、バールと戦うにはあまり\nに無力な自分が歯がゆくて... 。\n\nあらイヤだわ、勝手に自分の話ばかり\nして。ご挨拶もまだでしたわね。\n\nわたくしはマラー。アリート山に建つ\n秩序の最後の砦、ハロガスへようこそ。\n破壊の王バールと戦うおつもりでした\nら、ちょうどいいところに来てくださ\nいました。\n\n見ての通り、バールはわたくしたちの\n聖なる山を汚し、人々の命を奪いまし\nた。攻撃は今も続いており、クォル＝\nケックの率いる部隊では歯が立ちませ\nん。バールは山で何かを探しているよ\nうなのですけれど、それが何なのかは、\nわたくしにはわかりません。\n\nニーラサックを除く長老会の面々は、\nハロガスを守る結界を張るために残ら\nず命を落としました。\n\nニーラサックをはじめ、あなたの存在\nを快く思わない者もいるようです。我\nらは伝説の戦士であることに誇りを持っ\nておりますから、助けの手を差しのべ\nられることに抵抗があるのですね。し\nかしわたくし個人は、心から感謝して\nいますよ。\n\nヒーリングやポーションが必要なとき\nには、わたくしのところにおいでなさ\nい。武器や防具のことなら、ラーザッ\nクに頼めば大丈夫です。他に足りない\n物があれば、一応はニーラサックにも\n相談した方がいいでしょう。それから\nクォル＝ケックは、ハロガスの軍令長\nとしてバールと戦っている人ですから、\nあなたの力になってくれるかもしれま\nせん。\n
MalahAct5IntroBarGossip1	39\nあなたも、結局はこのバーバリアンの\n故郷へ帰ってきたのですね。あなたが\n冒険の旅をしている間に、ハロガスは\nすっかり変わってしまったでしょう。\n魔獣に埋め尽くされて、それこそ同じ\n土地とは思えないぐらい。\n\nそれでも、わたくしは何とか生きてい\nますわ。あなたもきっと辛いでしょう\nけれど、そうやって生きて帰ってくれ\nただけで、わたくしは大いに元気づけ\nられました。あなたの力を借りて、わ\nたくしたちがこの地獄から抜け出せる\nことを祈っております。\n\n見ての通り、バールはわたくしたちの\n聖なる山を汚し、人々の命を奪いまし\nた。攻撃は今も続いており、クォル＝\nケックの率いる部隊では歯が立ちませ\nん。バールは山で何かを探しているよ\nうなのですけれど、それが何なのかは、\nわたくしにはわかりません。\n\nニーラサックは長老会の唯一の生き残\nりですけれど、最近は様子がおかしい\nようです。他の長老たちが、ハロガス\nの街を守る結界を張るために命を落と\nしたのに、自分だけ生き延びたことに\n罪悪感を感じているようですね。もし\nニーラサックがあなたに辛く当たるよ\nうでも、それは若い人をこれ以上死な\nせたくないからだと思ってあげてくだ\nさいね。\n\nとにかく、この地はすっかり変わって\nしまいました。もう希望も持てないか\nと思うぐらいに。\n\nヒーリングやポーションが必要なとき\nには、わたくしのところにおいでなさ\nい。武器や防具のことなら、ラーザッ\nクに頼めば大丈夫です。他に足りない\n物があれば、一応はニーラサックにも\n相談した方がいいでしょう。それから\nクォル＝ケックは、ハロガスの軍令長\nとしてバールと戦っている人ですから、\nあなたの力になってくれるかもしれま\nせん。\n
MalahGossip1	50\nソーサレスの皆さんの素晴らしい魔力\nのことは、わたくしも知っているつも\nりですわよ。もしこの戦いに生き残る\nことができたら、実際の術を見せてく\nださらない？　よろしければ、いくつ\nか教わりたいわ。\n\n歳は取っていても、まだ死んだわけで\nはないんですからね。\n
MalahGossip2	45\nあなたと、私の息子バヌックとの仲が\nあまりよくなかったことは、覚えてお\nりますわよ。あの時のあの子には、故\n郷を離れて旅に出たいと思うあなたの\n気持ちが、理解できなかったのですね。\nでも、あの子も大きくなるうちに、あ\nなたと同じ事を考えたみたいですわよ。\n本人は認めようとしませんでしたけど\nね。\n\nあの時に、旅に出しておけばよかった\nと思いますわ。そうすれば、あの子は\n死なずにすんだかもしれないと。\n
MalahGossip3	55\nみんな、いざという時は氷の洞穴に避\n難しようと思っていたのですけど、そ\nれももう不可能になりましたわ。魔物\nどもに先回りされましてね。今あそこ\nに行ったら、寒さの前に恐怖で心が凍っ\nてしまいますわよ。\n
MalahGossip4	88\n戦場では、死体にさえも隙を見せない\nように注意しなくてはなりませんわよ。\n
MalahGossip5	53\n敵はどうやら、わたくしたちの心まで\n惑わしにかかっているようですのよ。\n山麓の戦場に出て、幸運にも生きて帰\nれた人たちは、天使が飛ぶのを見たと\n言っておりますの。飛ぶ者がいたから\nといって、それが天界から来たとは限\nりませんのにね。\n
MalahGossip6	45\nお聞き及びかも知れませんけれど、わ\nたくしの息子もバールの軍に立ち向かっ\nて、戦死いたしましたの。これで子供\nらには全員先立たれましたわ。\n\nヒーラーとして博愛の誓いは立てまし\nたけれど、それも相手が人間の場合だ\nけですわ。勇者さん、あいつらを皆殺\nしにしてくださいね！\n
MalahGossip7	55\n敵軍の使う投石機は、鋼鉄の機械に魔\n獣の血肉を組み込んだ地獄の兵器です\nわよ。お気をつけて。\n
MalahGossip8	45\nクォル＝ケックは最近の苦戦でうち沈\nんでいますけど、勇敢で公正な司令官\nです。あなたに冷たいように感じるの\nは、人を言葉ではなく行動で判断する\nためでしょう。信頼を得たければ、実\n績を示しておあげなさいな。\n
MalahGossip9	53\nラーザックはいい若者ですけれど、可\n哀想に最近の心労で参ってしまったよ\nうですわ。\n\nこの間なんか、わたくしの持っている\n上等の羊皮を20枚も欲しいと言ってき\nましてね。それで袋を作って、中に煙\nをためれば、雲みたいに空に浮かんで\nバールの軍勢を空から偵察できるんだ、\nとか言って！\n\n本当に可哀想に、おかしくなってしまっ\nたのだわ。\n
MalahGossip10	65\nお気をつけてね、勇者さん。わたくし、\n生きている方の傷なら治せますけれど、\n亡くなった方を蘇らせる力はありませ\nんから。\n
MalahGossip11	50\nいつの日か、自分たちの血で染まって\nいない真っ白な新雪をもう一度見たい\nと願って、祈っておりますのよ。その\n願いはもうすぐかなうのか、それとも、\n二度と...\n\n失礼、おしゃべりが過ぎましたわね。\n何のご用ですの？\n
MalahGossip12	53\n本当なら何でも無料で差し上げたいの\nですけれど、代金を払っていただいて\n助かりますわ。ごらんの通り物資が足\nりませんから、商人の方からは何でも\n言い値で買い取っておりますものでね。\n
MalahGossip13	38\nクォル＝ケックたち戦士を除けば、街\nで本当に戦況の厳しさを知っているの\nは、このわたくしだけでしょう。剛勇\nで知られた戦士たちが、傷ついた体を\n引きずって、泣きながらわたくしに助\nけを求めますのよ。治せる傷は全力で\n治しますけれど、中にはお気の毒に、\n手の施しようのない事もありますの。\n
NihlathakAct5IntroGossip1	47\nおやおや、戦争で何もかも不足してい\nると思っていたが、馬鹿者だけは減ら\nないようだな！\n\nこんな所まで、何をしに来たんだ？　\nハゲワシのように、戦死者の死体から\n鎧兜でもはぎ取って売るつもりかね？\n\n残念だが、君たちよそ者の出る幕では\nないよ。この山を守るのは私たちだ。\n地獄の魔物どもが全滅するのも、まあ\n時間の問題だね。\n
NihlathakAct5IntroAssGossip1	53\nおやおや、アサシンか！\n\nさぞかし街の者は大歓迎しただろう、\n殺しの達人が来てくれたと言ってね。\nだがまあ、私に言わせれば余計なお世\n話というものだ。\n\nいいかね、君などの手を借りることは\n何もないんだ。さっさと他の国へ行っ\nて、別の獲物を探すのだね。\n
NihlathakAct5IntroNecGossip1	44\nははあ、ネクロマンサーか。\n\n魔術の暗黒面を追及する蛮勇だけは見\n上げたものだが、正直、君などの出る\n幕ではないね。そんな術の力など借り\nなくても、戦況がすぐに逆転すること\nは明らかだよ。\n\nいやしかし、考えてみれば当然だな。\n君の目当ては、戦場の死体なんだろう？\nかがり火に集まる蛾のようなものだな。\n他人の死が、君にとっては生きる糧と\nいうわけだ。\n
NihlathakGossip1	40\nもし、堕落した魔道師を探していると\nいうのなら、ラーザックをよく調べて\nみてはどうかね。去年の春、街に猩紅\n熱が流行したとき、彼だけは感染しな\nかったんだ。本人は、運が良かったと\nか、食事の前によく手を洗ったとか言っ\nていたが、かなり怪しいね。\n
NihlathakGossip2	44\nこんな所まで、何をしに来たんだ？\nハゲワシのように、戦死者の死体から\n鎧兜でもはぎ取って売るつもりか？\n\n残念だが、君たちよそ者の出る幕では\nないよ。この山を守るのは私たちだ。\n地獄の魔物どもが全滅するのも、まあ\n時間の問題だ。\n
NihlathakGossip3	65\nクォル＝ケックは無能だよ。バールの\n軍勢を見くびって、兵を無駄死にさせ\nてばかりいる。魔物相手に一筋縄では\nいかない事など、誰にでもわかりそう\nなものだ。\n
NihlathakGossip4	55\n魔獣の軍団は、残念だが勢いを増す一\n方だ。それも、他ならぬ私たち自身の\n愚かな誤りを利用してね。だが私なら、\nその誤りを正すことができるのではな\nいかと思っている。\n
NihlathakGossip5	40\nもちろん、ここの戦士たちのことは、\n幼い頃からよく知っているとも。怪我\nや病気をする度に、マラーが治してやっ\nていたものだ。しかし今では誰もが、\n決して癒えない傷を負っている。\n\nもう疲れた... これ以上話しかけないで\nくれないか。\n
NihlathakGossip6	108\n何か役に立つ物はあるのかね？　\nないなら、あっちに行くんだな！\n
NihlathakGossip7	70\nアーニャの父親は、私の親友だった。\n他にも多くの友を弔わねばならない。\n君なんかの相手をしている暇はないん\nだよ。\n
NihlathakGossip8	48\n以前から私のことをなじる者は多かっ\nたが、最近他の長老たちが死んでから\nはなおさらだ。しかし結局、人間は自\n分の信念に従って行動するしかないの\nだよ。他人がなんと言おうともね。\n
NihlathakGossip9	58\n私たち長老会は、太古から魔王の来襲\nに備えてきたつもりだった。しかし結\n果を見ると、考えが甘かったと言うし\nかないようだな。\n
QualKehkAct5IntroGossip1	41\n俺はクォル＝ケック、このハロガスの\n軍令長だ。\n\n見たところ、お前さんも戦士のようだ\nな。加勢なら歓迎するぞ。ただし、死\nんだところで葬式も出ないから覚悟し\nとけ。\n\nバールはさすがに、破壊の王と言われ\nるだけのことはある。奴の軍勢は、疫\n病みたいにたちまち国中に広がっちまっ\nた。ここの城壁だけは、長老会の連中\nが命を捨てて結界を張ってくれたおか\nげで何とかもってるが、それにしたっ\nて楽じゃない。もう兵隊はほとんど死\nんじまったし、捕虜になった奴は山の\n方の牢屋に入れられてるらしい。\n\nだがな、まだ終わりじゃないぞ。俺た\nちは最後の最後までこの山を守って戦っ\nてやるからな！\n
QualKehkAct5IntroPalGossip1	40\nパラディンか！　お前さんらの騎士団\nの噂は聞いてるよ。\n\n俺も若い頃には、クラストに巡礼しよ\nうかとか思ってたんだ。しかしまあ、\nそんなのは若者の気の迷いだった。俺\nの仕事はこのハロガスにとどまって、\nアリート山を守ることだ。それ以外に\nは、ないのさ。\n\n俺はクォル＝ケック、このハロガスの\n軍令長だ。\n\nお前さんも戦士なんだろう。加勢なら\n歓迎するぞ。ただし、死んだところで\n葬式も出ないから覚悟しとけ。\n\nバールはさすがに、破壊の王と言われ\nるだけのことはある。奴の軍勢は、疫\n病みたいにたちまち国中に広がっちまっ\nた。ここの城壁だけは、長老会の連中\nが命を捨てて結界を張ってくれたおか\nげで何とかもってるが、それにしたっ\nて楽じゃない。もう兵隊はほとんど死\nんじまったし、捕虜になった奴は山の\n方の牢屋に入れられてるらしい。\n\nだがな、まだ終わりじゃないぞ。俺た\nちは最後の最後までこの山を守って戦っ\nてやるからな！\n
QualKehkAct5IntroDruGossip1	40\nドルイドが、このハロガスに？　こい\nつは驚いた！\n\nあの魔道師戦争の後じゃ、ハロガスに\n来るドルイドなんぞ金輪際いないだろ\nうと思ってたがね。お前さんもずいぶ\nん、物好きなんだな。\n\n正直言って、お前さんらの変身能力は、\n見ててあんまり気持ちのいいもんじゃ\nない。しかしまあ、秩序と平和を求め\nてるのはわかってるし、一目置いてる\nつもりだよ。俺たちを信用してこの街\nに来たんなら、こっちも信用して街に\n置いてやる。\n\n俺はクォル＝ケック、このハロガスの\n軍令長だ。\n\nお前さんも戦士なんだろう。加勢なら\n歓迎するぞ。ただし、死んだところで\n葬式も出ないから覚悟しとけ。\n\nバールはさすがに、破壊の王と言われ\nるだけのことはある。奴の軍勢は、疫\n病みたいにたちまち国中に広がっちまっ\nた。ここの城壁だけは、長老会の連中\nが命を捨てて結界を張ってくれたおか\nげで何とかもってるが、それにしたっ\nて楽じゃない。もう兵隊はほとんど死\nんじまったし、捕虜になった奴は山の\n方の牢屋に入れられてるらしい。\n\nだがな、まだ終わりじゃないぞ。俺た\nちは最後の最後までこの山を守って戦っ\nてやるからな！\n
QualKehkGossip1	53\n光輝の騎士がうちの味方になってくれ\nるとは、名誉なことだ。信心がお前さ\nんの強さの元なんだろ。ただし戦場で、\n正しい奴が勝つとは限らないぞ。\n
QualKehkGossip2	53\nハロガスに来てくれて助かったよ、ド\nルイドさん。だけど、地獄の軍勢にこ\nこまで汚された土地で、お前さんの自\n然魔法はちゃんと使えるのか？\n
QualKehkGossip3	38\nマラーの息子を亡くしたのは気の毒だっ\nたよ。あいつは全軍でも一番の弓兵だっ\nたんだ。あいつが部隊を指揮して、も\nう少しで作戦成功ってときに、敵の槍\nに串刺しにされてなあ。なんとか連れ\nては帰ったが、マラーにも治せないほ\nどの深手で、トドメをさしてやる以外\nに何もできなかった。\n
QualKehkGossip4	55\nバール軍の攻城兵器には、腕自慢の兵\n隊が何人もやられたよ。射程距離が長\nすぎてな。でも、一気に近距離まで詰\nめることさえできりゃ、後はこっちの\nもんだ。\n
QualKehkGossip5	83\nバールの軍団は、とにかくすごい大軍\nだ。ただし司令官を殺して指揮系統を\n混乱させれば、勝機はある。\n
QualKehkGossip6	53\n最初の頃に、腕利きの偵察部隊がいく\nつも奇襲を受けて全滅した。なんでも、\n魔物がいきなり宙から出てきたって言\nうんだ。生存者の話じゃ、ちょっと離\nれたところの空に変な怪物が浮かんで\nいたらしい。\n\nそいつが敵の先触れなら、急いで倒し\nておけば奇襲を防げるかもしれん。\n
QualKehkGossip7	55\n魔物どもは、強いのももちろんだが、\n何より気分が悪いな。俺たちは戦場に\n兵糧を持って行くが、奴らは毎晩俺た\nちの仲間の死体を喰ってやがる。\n
QualKehkGossip8	48\nラーザックは、鍛冶の腕はいいんだが、\nいつでも何か変なことばっかり考えて\nる奴だ。\n\nこないだ、敵の包囲を打ち破る作戦っ\nてのを聞かされたが、また途方もない\n話だった。でっかい筒に爆薬と鉄の玉\nを詰めて、それに火をつけるそうだ。\nムチャクチャだね。\n
QualKehkGossip9	44\n平和なときには長老会が街をうまく動\nかしてたが、今この戦争を指揮してる\nのは俺だ。俺も部下どもも死ぬまで戦\nうつもりだが、さてその結果がどうな\nるかは、正直言ってわからん。\n\n俺はずっと、この街の防備を破って聖\nなる山に攻め込む力を持った奴なんか、\nどこにもいないと信じていた。でも見\nての通り、大間違いだったのさ。\n
A5Q1InitLarzuk	52\nあんたはこの街を救いに来たって話だ\nが、俺たちゃ口先だけの奴は信用しね\nえんだ。\n\nバールを倒しに来たっていうなら、腕\n前を見せてもらおうじゃないか。\n\nこの通り、ハロガスはバールの軍に包\n囲されて、ずっと攻撃を受けてる。特\nに敵の投石機はすげえ勢いで、このま\nまじゃもう時間の問題だ。\n\n総大将のバール本人は今、アリート山\nに行ってる。包囲軍の指揮を任されて\nるのはシェンク・ジ・オーヴァーシー\nアーっていう将軍だ。こいつの部隊は\nムチャクチャで、いつでも死ぬ気で攻\nめ寄せてきやがる。\n\nもしあんたがホントに勇者さまなら、\nシェンクの野郎を討ち取って投石攻撃\nを止めさせてくれねえか。その後で生\nきて帰ってこられたら、俺からちょっ\nとした礼をさせてもらうよ。\n
A5Q1AfterInitLarzuk	125\n投石機を止めろって話はしたよな？\n
A5Q1AfterInitCain	73\nこの街の人間に信用されたければ、シェ\nンクを倒して包囲を解かせるしかない\nだろうな。\n
A5Q1AfterInitAnya	80\nあなた、若い娘を助ける腕前は確から\nしいけど、怪物の将軍を倒す腕の方は\nどうなの？\n
A5Q1AfterInitMalah	75\nクォル＝ケックと部下たちも、包囲網\nを破ろうと何度も戦いを挑みましたけ\nど、犠牲が増すばかりで成果は挙げら\nれませんでした。でも、あなたなら可\n能かも知れませんわね。\n
A5Q1AfterInitNihlathak	65\nわが街の精鋭たちに倒せなかった敵を、\n君は本気で討ち取る気でいるのかね？\n何様のつもりだ？\n
A5Q1AfterInitQualKehk	65\nシェンク・ジ・オーヴァーシーアーを\n討ち取って、包囲を解かせるつもりな\nんだろ？　だったら出陣の前にマラー\nのところへ寄って、最後のお祈りをし\nてもらっておけよ。\n
A5Q1EarlyReturnLarzuk	75\n何やってんだ勇者さん？　俺たちのガ\nマンの限界を試すつもりか？\n
A5Q1EarlyReturnCain	88\nためらう気持ちは分かるが、今は一刻\nを争う時だ。行くしかあるまい。\n
A5Q1EarlyReturnAnya	55\nあの魔物どもは、あなたが来る前から\nここを包囲してるのよ。本当にやる気\nはあるの？　仕事は簡単よ。シェンク\nを捜し出して、息の根を止めるだけで\nいいから。\n
A5Q1EarlyReturnMalah	64\n慰めになるかどうかわかりませんけど、\n今までにシェンク討伐を試みた方々に\n比べれば、あなたはよくやっておいで\nですよ。\n\nシェンクと戦う際には、ひとつ覚えて\nおおきなさい。将軍というものは、手\n近に部下がいなければ無力なものです\nわ。\n
A5Q1EarlyReturnNihlathak	73\nこんな所で、いったい何をしている？\n君は死にに出て行ったはずだろう？　\n\nさっさと出ていって、さっさと死んで\nくれないか。\n
A5Q1EarlyReturnQualKehk	82\nおう、まだ生きてたか。よっぽど足が\n速いか、でなけりゃひどい腰抜けなん\nだろうな。\n
A5Q1SuccessfulLarzuk	58\nあんた、すげえじゃねえか。今までナ\nメた口きいてすまなかったな。\n\nお礼のしるしに、あんたの好きなアイ\nテムにソケットを作ってやるよ。それ\nに、これからはギリギリまで安い値段\nで取り引きさせてもらうぜ。\n
A5Q1SuccessfulCain	65\nまったく、あんな恐ろしい投石機は今\nまで見たことがなかったな。しかしシェ\nンクを倒したとはいえ、真の敵である\nバールはまだぴんぴんしておるぞ。\n
A5Q1SuccessfulAnya	88\nいったいいつまでかかるのかと思った\nけど、本当にシェンクを倒せたのね。\n大したもんだわ。\n
A5Q1SuccessfulMalah	66\nこれで、ようやく攻撃がやみました。\nあなたは本当に、天使ですわ。感謝い\nたします。\n
A5Q1SuccessfulNihlathak	51\n包囲攻撃を止めたぐらいで尊敬される\nと思ったら、それは大きな間違いだ。\n尊敬を勝ち取るには自己犠牲が必要な\nのだよ。果たして、君にそんな立派な\n心構えができているかね？\n
A5Q1SuccessfulQualKehk	53\nほほう、本当に投石攻撃を止めさせた\nか。お前さん、思ったよりずっと腕が\n立つようだな。これからは一目置かせ\nてもらうぞ。\n
A5Q2InitQualKehk	53\n実を言うと、敵の捕虜になった部下の\nことがずっと気にかかってるんだ。連\n中がどんな目に遭ってるかと思うだけ\nで、いてもたってもいられない。\n\nもし、山を目指す途中で捕虜を見つけ\nたら、なんとか連れて帰ってやってく\nれないか。\n
A5Q2AfterInitQualKehk	68\n自力で逃げ帰った部下の話によると、\nバールの部隊は高原や台地に牢屋を作っ\nて捕虜を押し込めてるらしい。それら\nしい場所に出たら、よく探してくれ。\n
A5Q2AfterInitCain	65\n私にも経験のあることだから、とらわ\nれの身がどんなに辛いものか、よくわ\nかる。早く助けてやってくれ。\n
A5Q2AfterInitAnya	77\n捕虜が、みんな私のときみたいな扱い\nを受けてるなら、長くは生きられない\nはずよ。早く解放してやって。\n
A5Q2AfterInitLarzuk	60\nクォル＝ケックの部下たちは、俺の作っ\nた武器や防具を持って戦場に出た。俺\nにとっちゃ兄弟も同様なんだ。どうか\n助けてやってくれ。\n
A5Q2AfterInitMalah	66\n兵士たちはかなり前から幽閉されてい\nますから、すっかり弱り果てているは\nずです。解放した後は、敵から守って\nあげてくださいね。\n
A5Q2AfterInitNihlathak	86\n命を奪うのが得意なのはわかったが、\n命を救う腕前の方はどうかな？\n
A5Q2EarlyReturnQualKehk	80\n慎重と優柔不断は違うぞ。今は決断と\n実行の時だ。大急ぎで頼む。\n
A5Q2EarlyReturnQualKehkMan	80\nまだまだ、敵の捕虜になってる兵隊が\nいるはずだ。間違いない。\n\n何とか連中を見つけて、檻から助け出\nして、生きたまま連れて帰ってくれ。\n頼む。\n
A5Q2EarlyReturnCain	58\n捕虜になった兵隊が見つからないよう\nなら、マラーに相談してみるといい。\n彼女は牢屋から脱走してきた兵隊も治\n療したから、何か事情を知っておるか\nもしれんよ。\n
A5Q2EarlyReturnAnya	88\n私を助け出したあなたのことだから、\n兵たちもきっと助けてくれると信じて\nるわ。\n
A5Q2EarlyReturnLarzuk	75\n俺もガキの時分にゃ山のバリケードを\n走り回って遊んだもんだが、ありゃあ\nまるで迷路だろ。簡単には抜けられね\nえぞ。\n
A5Q2EarlyReturnMalah	63\n敵の手を逃れた人たちの話によれば、\n捕虜は山道の間にあるバリケードにと\nらわれているようですわよ。\n
A5Q2EarlyReturnNihlathak	50\n君は、魔物がどうしてクォル＝ケック\nの部下を捕虜にするか、考えたことが\nあるかね？　連中が私たちを襲う理由\nは？　バールが山で何を探しているか、\n想像したことが一度でもあるか？\n\nないだろう。ないに決まっているんだ。\n君には何もわかっていない。\n
A5Q2SuccessfulQualKehk	54\n部下の命を救ってくれて、本当にあり\nがとうよ。お前さんの勇気は、連中か\nら散々聞かされた。これで俺たちも、\n少しは希望が持てそうだ。\n\nよかったらこの先、お前さんの助けた\n兵隊を傭兵に使ってやってくれ。それ\nから、礼の代わりと言っちゃなんだが、\nこのルーンをもらってくれないか。ソ\nケット・シールドに入れようと思って\n置いてあったんだが、お前さんが持っ\nてた方が役に立つだろう。\n\nソケットに入れるときは、ちゃんとし\nた順番じゃないと本当の効果が出ない\nから、気をつけるんだな。\n
A5Q2SuccessfulCain	68\n君はすっかり街の英雄だな。君が光輝\nを放ってくれたおかげで、ずっとハロ\nガスを覆っていた影も遠のいたように\n思えるよ。\n
A5Q2SuccessfulAnya	88\n助けた兵士たちは、みんなあなたに心\nから感謝してるはずよ。私みたいにね。\n
A5Q2SuccessfulLarzuk	55\nあんたの南の方での武勇伝は、ケイン\nから散々聞かされてるぜ。メフィスト\nもディアブロもあんたが倒したんだっ\nて。初めて聞いた時ゃあ笑っちまった\nが、最近の活躍を見てると、どうやら\n信じてもよさそうだな。\n
A5Q2SuccessfulMalah	67\nあなたは、とらわれた兵士を解放した\nだけでなく、街にいる者たちをも救っ\nてくださいましたわ。おかげで、希望\nが持てるようになりましたもの。\n
A5Q2SuccessfulNihlathak	67\nほう、迷える子羊を羊飼いの元に導い\nたか。お見事だよ、まったく。\n
A5Q3InitMalah	44\n大変申し上げにくいのですが、あなた\nの他にご相談する方はいないと信じて、\nうち明けたい話があります。\n\n亡くなった長老の娘で、アーニャとい\nう名の錬金術師が、しばらく前から姿\nを消しておりますの。年は若いながら\nしっかりした子で、気の迷いというこ\nとは絶対にございません。実を申しま\nすと、あなたがお見えになるちょうど\n前の晩、彼女とニーラサックが長老た\nちの死について言い争うのを、わたく\nし聞いてしまいました。そして翌朝、\n彼女は消えていたのです。\n\nニーラサックはアーニャが消えた理由\nについて勝手に何か言っているようで\nすが、お信じにならない方が賢明です\nわよ。わたくしは、彼がアーニャの失\n踪に関わっていると思っております。\n\nもしできましたら、アーニャを探して、\n助け出してくださいな。ニーラサック\nのことは、それから本人に決めてもら\nいましょう。\n
A5Q3AfterInitMalah	85\nニーラサックの話を聞かれるときは、\nお気をつけなさい。あの人が真実を語っ\nているという証拠はありませんわよ。\n
A5Q3AfterInitCain	48\nマラーの言う通り、ニーラサックはど\nうも信用できんな。常に毒舌を振るっ\nて、街の運命をひとりで背負っている\nかのような態度だ。何か、影で企んで\nおるのかもしれんぞ。\n
A5Q3AfterInitLarzuk	58\nアーニャはまだ若いんだが、錬金術師\nとしちゃなかなか大したもんさ。しか\nも気丈な子でね。いったん心を決めた\nらテコでも動かねえんだ。\n\nニーラサックがなんか関わってるのは、\n間違いないと思うぜ。アーニャの親父\nさんが死んでから、あのふたりは仲が\n悪かったからな。\n
A5Q3AfterInitNihlathak	41\nアーニャだって？　その話をどこから\n聞いたんだ？　どうせまた、お節介な\nマラーに吹き込まれたんだろう。\n\nいいかね、本当のことを教えるから、\nよく聞くんだ。あの晩アーニャは私に、\n相談に来たんだ。母親と弟が氷の洞穴\nの向こうにとらわれている姿が、占い\nに出たと言ってね。それで、助けに行\nくことに決めたというんだよ。\n\n私はもちろん、無茶はよせと言って必\n死に止めたんだが、なにぶん強情な娘\nだから、どうしても聞こうとしなかっ\nたのだ。\n\n結局、翌朝にはアーニャは消えていた。\n私ほどあの子の失踪を嘆いている者は、\n他にあるまい。\n\nしかしまあ、君がどうしてもマラーの\n使い走りをしたいというなら、強いて\n止めはしないさ。好きにしたまえ。\n
A5Q3AfterInitQualKehk	40\nアーニャの父親のオーストは、長老会\nの重鎮だったと言っていいだろうな。\nオーストは、他の長老たちと一緒に街\nを守る結界を張っていて、バールの軍\n勢に殺されたんだ。この結界のおかげ\nで街は今まで持ちこたえたわけだが、\nそれにしても高い代償だった。\n\n生きて帰った長老はニーラサックただ\nひとりだ。多分、仲間が殺されてる間、\nどっかに隠れていたんじゃないか。\n\nそれ以来、ニーラサックとアーニャは\n犬猿の仲なんだよ。\n
A5Q3EarlyReturnMalah	50\n消えたのが他の人なら、もう死んだと\n思ってあきらめるところです。しかし\nアーニャは強い子ですから、簡単に命\nを落とすはずがありませんわ。\n
A5Q3EarlyReturnCain	53\nアーニャについて聞いた噂を考えると、\nニーラサックの話はいっけん筋が通っ\nておるようだな。しかし巧妙な嘘は、\nしばしば真実の影に隠れておるものだ。\n
A5Q3EarlyReturnLarzuk	55\nニーラサック以外でアリート山の秘密\nを隅々まで知ってるのは、オースト長\n老の娘のアーニャだけだったんだ。も\nしもアーニャが戻らねえんだったら、\nニーラサックに頼るしかねえ。たまん\nねえぜ。\n
A5Q3EarlyReturnNihlathak	45\n言っただろう、アーニャはもう死んだ\nんだよ。少しでも道理がわかるなら、\n死人を捜そうなどと思う前に、ハロガ\nスを救うことに専念したらどうだね。\n
A5Q3EarlyReturnQualKehk	63\nみんな、ニーラサックがアーニャの失\n踪に一枚噛んでると思ってるようだな。\nだが、だとしたら動機は何なんだ？\n
A5Q3FoundAnyaMalah	50\nやはり！　あのニーラサックがアーニ\nャを罠にかけて、氷の牢獄に幽閉した\nのですね。\n\nさあ、このポーションをアーニャに飲\nませてあげてください。それで動ける\nようになるはずですわ。\n
A5Q3FoundAnyaCain	45\nなんと、アーニャはあのニーラサック\nの呪いを受けて凍結されておったわけ\nか... すぐマラーに相談してみたまえ。\n私では力になれん。\n
A5Q3FoundAnyaLarzuk	80\nアーニャも気の毒に！　そうか、ニー\nラサックが裏切ってたのかい！\n\nもしあの野郎を見つけたら、俺の代わ\nりに八つ裂きにしてやってくれよ！\n
A5Q3FoundAnyaQualKehk	63\n惜しかったな。お前さんが留守の間に、\nニーラサックは消えやがったよ。\n\nアーニャならきっと、行方を追う手だ\nてを知ってるはずなんだが。\n
A5Q3FoundAnyaAnya	48\n... 寒い... ニーラサックにやられたのよ！\n\nあなた、私を助けに来たなら、街に帰っ\nてマラーに相談して。\n\n私を解放できるのは多分、あの人だけ\nよ... 。\n
A5Q3SuccessfulMalah	46\nアーニャを救い出してくださって、本\n当にありがとうございます。この呪文\nは、あなたの耐性を高めるために編み\n出したものです。ささやかですけれど、\n勇者さんのお役に立てれば幸いですわ。\n\nそうそう、アーニャの話をお聞きなさ\nいな。ニーラサックのことで急いで相\n談したいと言っておりましたわよ。\n
A5Q3SuccessfulCain	48\nまだ若いのに、アーニャはずいぶん町\nの人に尊敬されておるようだね。ぜひ\n彼女から、アリート山について聞いて\nおいた方がいい。\n
A5Q3SuccessfulLarzuk	66\n前からニーラサックはヤな野郎だと思っ\nてたが、まさか街を裏切ってたとはな\nあ！　長老がそんなことをするなんて、\n夢にも思わなかったぜ。\n
A5Q3SuccessfulQualKehk	99\nアーニャを助けてくれて、ありがとう\nよ。\n
A5Q3SuccessfulAnya	79\nありがとう勇者どの、あなたは命の恩\n人だわ。\n\nお礼のしるしに、これを受け取って。\nラーザックに頼んで、あなたのために\n特別に作ってもらったのよ。\n
A5Q4InitAnya	45\nあなたが街に来る前の晩、ハロガスの\n街を救う計画があると、ニーラサック\nが言ったの。私たちの先祖代々の宝\n「古き物の遺宝」を渡す代わりに、街\nを見逃してもらうようバールと約束し\nたというのよ。でも、「遺宝」を持つ\n者は誰でも、古き民のとがめを受けず\nにアリート山に入ることができてしま\nうわ。もちろん私はニーラサックを止\nめようとしたけど、逆にあの氷に閉じ\nこめられてしまったわけ。\n\nニーラサックがバールに宝を渡す前に\n止めないと、世界は破滅よ！　できる\nことなら自分で彼を絞め殺してやりた\nいけど、無理みたいだからあなたに頼\nむわ。\n\n私が開いたポータルを通って、ニーラ\nサックを追って。それから彼を殺して、\n遺宝を取り戻してちょうだい。私たち\nが大昔から守り続けてきたものを、こ\nんなことで台無しにさせるわけにはい\nかない。\n
A5Q4AfterInitAnya	73\nいくら街を守るためにやったことでも、\nニーラサックは許せないわ。\n
A5Q4AfterInitCain	43\n残念ながら、その遺宝についてはよく\nわからん。しかし、もし皆の言うこと\nが本当なら、バールには絶対渡せない\n品物だな。すべてが滅びる前に、ニー\nラサックを止めてくれ。\n
A5Q4AfterInitMalah	62\n最も恐れていたことが、とうとう現実\nになってしまいましたわ。ニーラサッ\nクは正気を失ったのですね。\n\n古き民の遺宝が破壊の王の手に渡る前\nに、何としても彼を止めてください！\n
A5Q4AfterInitLarzuk	57\nアーニャを助けてくれたか、そいつぁ\nよかった。でも、こうやって話してる\n間にも、ニーラサックはバールに宝を\n渡してるかもしれねえ。まずいぞ。\n
A5Q4AfterInitQualKehk	53\nお前さんがアーニャを見つける直前に、\nニーラサックが街から出ていくのを見\nかけたんだ。俺は一度、あの男の言い\n分を聞きたい。\n\nもしできたら、生きたまま引きずって\n帰ってくれないか。抵抗するようだっ\nたら、殺すしかないだろうがな。\n
A5Q4EarlyReturnAnya	53\nニーラサックは裏切り者よ！　もし古\nき民の遺宝がバールの手に渡ったら、\n聖なる山はたちまち荒らされてしま\nう！\n\n他でもない破壊の王に世界を滅ぼす手\n段を提供して、その代わりに街が救わ\nれると思ってるなんて... ニーラサッ\nクは本当におかしくなってしまったの\nね。\n
A5Q4EarlyReturnCain	50\nまったく、恐ろしいことになったもの\nだ。君はいつも、敵の一歩後ろを追う\n定めのようだな。しかしまあ、魔王も\n君を恐れて逃げているのだと思えば、\nまだ救われるか。\n
A5Q4EarlyReturnLarzuk	99\nなに油売ってんだよ。さっさとニーラ\nサックを殺せよ。\n
A5Q4EarlyReturnMalah	51\nニーラサックはたしかに、誰にでも好\nかれる人ではありませんでしたけど...\nまさか全世界を裏切る暴挙に出るとは。\n彼の魂に何があったというのでしょう？\n
A5Q4EarlyReturnQualKehk	60\n素早く立ち回って、ガツンとやってや\nれ。ニーラサックは、今までお前さん\nが倒してきた魔物みたいな、強い敵じゃ\nないんだからな。\n
A5Q4SuccessfulAnya	47\nニーラサックは倒したのに、「古き民\nの遺宝」はなかった... もう、バールの\n手に渡ってしまったのね。となると、\nバールは古き民にとがめられることな\nく、アリート山に入ってしまうわ。何\nてこと！\n\nでも、とにかくありがとう。その勇気\nを称えるために、好きなアイテムに魔\n法であなたの名前を刻印してあげるわ。\nせめてものお礼よ。\n
A5Q4SuccessfulCain	85\n気をつけよ。バールは刻一刻と力を増\nしておるはずだぞ！\n
A5Q4SuccessfulLarzuk	88\nバールの奴め、アリート山に入って何\nをする気なんだ？\n
A5Q4SuccessfulMalah	65\n遺宝は間に合いませんでしたか。しか\nし、過ぎたことを悔やんでも仕方あり\nませんわ。未来を見なくては。\n
A5Q4SuccessfulQualKehk	40\nニーラサックの畜生め、とうとう文字\n通り地獄に落ちたわけか。しかしお前\nさんは、腕前といい度胸といい、大し\nたもんだな。\n
A5Q5InitQualKehk	41\nお前さんはみるみるうちに手柄を立て\nるんだな。もう、ほとんど伝説になっ\nてるよ。\n\nしかし気をつけろよ。これから向かう\nアリートの山頂は、この俺でもまだ近\n寄ったことのない、聖地の中の聖地だ。\n伝説によると、そこには俺たちの先祖\n「古き民」の霊がいて、山にふさわし\nい勇気を持った者以外は絶対に通さな\nいそうだ。\n\n俺たちがどう思おうと関係ない。古き\n民が、お前さんを値踏みするわけだ。\n\n気をつけてな。\n
A5Q5AfterInitQualKehk	60\nよく覚えとけ、古き民は敵じゃない。\n俺たちの先祖で、守り神なんだ。\n
A5Q5AfterInitCain	83\n聖地に踏み入るのに腕試しをされると\nいうのも、いかにもバーバリアンらし\nい儀式だな。\n
A5Q5AfterInitAnya	65\nニーラサックが「古き民の遺宝」を盗\nみ出さなければ、試練を受ける必要も\nなかったのにね。本当に、思い出すた\nびに腹が立つわ。\n
A5Q5AfterInitLarzuk	70\n俺ぁ毎晩、早く平和が戻るようにって、\n古き民に祈ってんだぜ。その古き民と、\nあんたが戦うってのかい。\n\nこれからは誰に祈りゃあいいんだ？\n
A5Q5AfterInitMalah	61\nもし山頂に立つことができたなら、あ\nなたはもうただの戦士ではありません\nわ。人の身でありながら、人を超えた\n存在になるのです。\n
A5Q5EarlyReturnQualKehk	70\n言っただろう、古き民はお前さんが今\nまで戦ってきた化け物とは違うって。\n
A5Q5EarlyReturnCain	50\nここまで来たらもう後戻りはできんぞ。\n君は、今まで数々の困難を乗り越えて\nきた勇者ではないか。今度の試練はか\nつてないほど厳しいかもしれんが、そ\nれでも君なら必ずできると信じておる\nよ。\n
A5Q5EarlyReturnAnya	55\nごめんなさいね。あなたがこうして苦\n労しているのは、半分は私のせいだわ。\nニーラサックがバールに「古き民の遺\n宝」を渡すのを止められていれば、試\n練なんか必要なかったはずなのに。\n
A5Q5EarlyReturnLarzuk	65\nあんたは、俺たちの大事なご先祖様の\n聖地を踏み荒らしてきたわけだ。よろ\nしく頼むと頭を下げるべきか、この野\n郎と怒鳴るべきか、迷っちまうぜ。\n\nとにかく、俺たちの神様によろしくな。\n
A5Q5EarlyReturnMalah	68\n迷わずにお進みなさいな。あなたには\n聖なる山に入る資格があると、わたく\nしは信じておりますわ。あなたもご自\n分を信じなくては。\n
A5Q5SuccessfulQualKehk	68\nとうとう、古き民にまで勝てたか！\nこの調子で、バールにも勝てればいい\nな。\n
A5Q5SuccessfulCain	68\nすっかり人々の信頼を得たな。もう君\nは彼らの仲間、彼らの代表になったの\nだ。\n
A5Q5SuccessfulAnya	68\nあなたこそ、このハロガスが誇る勇者。\nそして全世界の、最後の希望だわ。\n\nがんばってね！\n
A5Q5SuccessfulLarzuk	68\n古き民まであんたを認めたなら、もう\n間違いねえや。これからは全力で応援\nするぜ。\n
A5Q5SuccessfulMalah	66\n思った通り、古き民はあなたがアリー\nト山の秘密を知るにふさわしいと判断\nしたのですね。さあ、すべてが滅びる\n前に、急いでバールを止めてください。\n
A5Q6InitAncients	30\n気高き勇者よ！　汝に望むスキルを授\nけ、アリート山の内部に立ち入る許可\nを与えよう。ワールドストーンは、こ\nの山の中に安置されておる。\n\nなれど心せよ、破壊の王バールは、す\nでに汝の先を行っておるのだからな。\n\n今まで、我らは常に大天使ティラエル\nのご加護を受けておったが、そのお力\nもこの先には及ばぬ。バールがワール\nドストーンの安置室に結界を張り、聖\n霊の力を閉め出してしまったのだ。命\nある人の子よ、今バールに立ち向かう\n力を持つ者は、ただ汝のみなのだ。\n\nもしバールがワールドストーンを害す\nることがあれば、この地上界そのもの\nが危機に陥るであろう。バールはどう\nやら、ワールドストーンの力を操って、\n現世と燃え盛る地獄との境界を破壊し\nようとしておるようだ。万が一にもこ\nの企てを許せば、津波のごとく押し寄\nせる忌まわしき魔獣の群れを防ぐ手段\nは、どこにもあるまい。\n\nもし汝が敗れれば、今あるこの世界は\n永遠に失われてしまうのだ。必ずや魔\n王を討ち取らねばならぬぞ！\n
A5Q6EarlyReturnCain	40\n忘れるな。今のバールは、ホラドリム\n史上最高とも言われた魔道師タル・ラ\nシャの心身を奪っておるのだ。破壊の\n王の暗き魔力にタル・ラシャの知識が\n加わったとなれば、その猛威はメフィ\nストやディアブロの比ではあるまい。\nこれからの戦いは、山々をも揺るがす\n激戦になるに違いないぞ。\n
A5Q6EarlyReturnLarzuk	55\n俺はしがない武具師だが、この俺でも\nバールのやろうとしてることはわかる。\n奴は、聖なる山に隠された力を悪用し\nて、この世を滅ぼそうとしてやがるん\nだろ。お願いだからしっかり頼むぜ、\n勇者さま。\n
A5Q6EarlyReturnMalah	66\nいずれ避けられない戦いであると、あ\nなたにもわかっていたはずです。どう\nかバールを討ち、戦いを終わらせてく\nださい。\n
A5Q6EarlyReturnAnya	53\nワールドストーンの安置室にバールが\n結界を張ったおかげで、ティラエルの\n力が及ばないんですって？　だとする\nと、あなたひとりで地獄全部を敵に回\nして戦うわけね。もう天界の意志なん\nか関係ない。これはあなたの、運命の\n闘いよ。\n
A5Q6EarlyReturnQualKehk	57\nお前さんは、伝説も予言も及ばない戦\nいを乗り越えて、想像もできない魔王\nに挑んでるんだな。\n\nどうか気をつけてくれよ。それから、\n光輝の導きがありますように。\n
A5Q6SuccessfulTyrael	40\n見事であったな、勇者よ。そなたは創\n世以来この世界に降りかかった最大の\n危機を見事に乗り越え、三人の魔王を\n残らず討ち取ったのだ。しかし、もは\nやワールドストーンを浄化することは\nかなわぬ。バールのおぞましき力が、\nかの石を完全に汚染してしまった。\n\nもしこのまま捨て置けば、ワールドス\nトーンの魔力は闇に吸い尽くされ、地\n上界と地獄界を隔てる壁がついえ去っ\nてしまうはずだ。さすれば、地獄の魔\n獣どもがたちまち地上にあふれ出し、\nそなたら人類も、無論その文明も、残\nらず灰燼に帰すこととなろう。\n\nかくなる上は、地獄の力が完全に及ぶ\n前に、ワールドストーンを砕くしかな\nい。これで世界の姿は一変し、永遠に\n元には戻らぬ。何が起こるか、我にす\nら予測はできぬのだ。されど、人類を\n救う道はこれより他にない。\n\n立ち去るがよい、勇者よ。我の開いた\nポータルを通れば、安全な地へ行けよ\nう。\n\nそなたと、そなたの子孫たちの歩む道\nを、永遠の光輝が照らし出さんことを。\n\n人類の存続こそが、今日そなたのなし\nた偉業の証左。そなたはこれにて、果\nてしなき戦いより解放されるのだ！\n
A5Q6SuccessfulAnya	50\n信じられない。素晴らしいわ。魔王を\n残らず滅ぼしたなんて。光輝の得た最\n大の勝利ね。\n\nでも、ワールドストーンを砕くしかな\nいというのは不思議ね。予言には、そ\nんな話は全然なかったのに。もしかす\nると、私たちが守って戦ってきたもの\nが、永遠に失われるのかもしれない。\nでもこれで、もう戦わなくてすむのか\nもしれないわね。\n
A5Q6SuccessfulCain	35\n君ならきっとバールを倒せると思った\nよ。トリストラムの街で救われて以来、\nずっと君を信頼しておった。そしてそ\nの期待にたがわず、君は幾多の偉業を\nなしとげてきたのだ。君を補佐できた\nことは、この上ない栄誉だ。\n\nそうか、ワールドストーンはすでにバー\nルに汚され、ティラエルが打ち砕くこ\nとになったか。しかし心配はあるまい。\nこの先何が待ち受けていようとも、光\n輝が我らを導いてくださるさ。\n\nさあ、ワールドストーンの安置室に戻\nり、ティラエルが開いたポータルを通\nるがいい。\n
A5Q6SuccessfulLarzuk	60\nみんな大喜びで、あんたを称える歌を\n歌ってるぜ。古き民もうらやましがる\nだろうな。\n\nこれからも、俺たちのことは忘れない\nでくれよ。じゃあな！\n
A5Q6SuccessfulMalah	49\nティラエル様がワールドストーンを砕\nくしかないと言われたのならば、そう\nするしかないのでしょう。地獄の力を\n地上に放つわけにはまいりませんもの。\nしかし、これで世界が変わるとしても、\n悪くなるとは限らないわけでしょう？\n
A5Q6SuccessfulQualKehk	53\nワールドストーンを砕かなきゃならな\nいとは、正直言って不吉だな。しかし\nまあ、心配はしないでおこう。なにし\nろ光輝の軍勢には、お前さんみたいな\n勇士がいるんだからな！\n\nあばよ！\n
ktr	カタール
wrb	リスト・ブレイド
ces	セスタス
clw	クローズ
btl	ブレイド・タロンズ
skr	シザース・カタール
9ar	クハーブ
9wb	リスト・スパイク
9xf	ファシア
9cs	ハンド・サイズ
9lw	グレイター・クローズ
9tw	グレイター・タロンズ
9qr	シザース・クハーブ
7ar	スゥエイヤー
7wb	リスト・ソード
7xf	ウォー・フィスト
7cs	バトル・セスタス
7lw	フェラル・クローズ
7tw	ルーニック・タロンズ
7qr	シザース・スゥエイヤー
7ha	トマホーク
7ax	スモール・クレッセント
72a	エティン・アックス
7mp	ウォー・スパイク
7wa	バーサーカー・アックス
7la	フェラル・アックス
7ba	シルバー・エッジド・アックス
7bt	ディキャピテイター
7ga	チャンピオン・アックス
7gi	グロリアス・アックス
7wn	ポリッシュト・ワンド
7yw	ゴースト・ワンド
7bw	リッチ・ワンド
7gw	アンアースト・ワンド
7cl	トランチャン
7sc	マイティ・セプター
7qs	セラフ・ロッド
7ws	カデューシアス
7sp	タイラント・クラブ
7ma	リインフォースト・メイス
7mt	デヴィル・スター
7fl	スカージ
7wh	レジェンダリー・マレット
7m7	オウガ・モール
7gm	サンダー・モール
7ss	ファルカタ
7sm	アタガン
7sb	エレガント・ブレイド
7fc	ハイドラ・エッジ
7cr	フェイズ・ブレイド
7bs	コンクエスト・ソード
7ls	クリプティック・ソード
7wd	ミシカル・ソード
72h	レジェンド・ソード
7cm	ハイランド・ブレイド
7gs	バルログ・ブレイド
7b7	チャンピオン・ソード
7fb	コロッサス・ソード
7gd	コロッサス・ブレイド
7dg	ボーン・ナイフ
7di	ミスリル・ポイント
7kr	ファングド・ナイフ
7bl	レジェンド・スパイク
7tk	フライング・ナイフ
7ta	フライング・アックス
7bk	ウィングド・ナイフ
7b8	ウィングド・アックス
7ja	ハイペリオン・ジャベリン
7pi	スティジアン・パイラム
7s7	バルログ・スピア
7gl	ゴースト・グレイヴ
7ts	ウィングド・ハープーン
7sr	ハイペリオン・スピア
7tr	スティジアン・パイク
7br	マンキャッチャー
7st	ゴースト・スピア
7p7	ウォー・パイク
7o7	オウガ・アックス
7vo	コロッサス・バウルジ
7s8	スレッシャー
7pa	クリプティック・アックス
7h7	グレイト・ポールアックス
7wc	ジャイアント・スレッシャー
6ss	ウォーキング・スティック
6ls	スタラグマイト
6cs	エルダー・スタッフ
6bs	シレイリ
6ws	アーカン・スタッフ
6sb	スパイダー・ボウ
6hb	ブレイド・ボウ
6lb	シャドウ・ボウ
6cb	グレイト・ボウ
6s7	ダイアモンド・ボウ
6l7	クルセイダー・ボウ
6sw	ウォード・ボウ
6lw	ハイドラ・ボウ
6lx	ペレット・ボウ
6mx	ゴーゴン・クロスボウ
6hx	コロッサス・クロスボウ
6rx	デーモン・クロスボウ
ob1	イーグル・オーブ
ob2	セイクリッド・グローブ
ob3	スモークト・スフィア
ob4	クラスプト・オーブ
as1	ラップス
as2	ナックルズ
as3	スラッシャーズ
as4	スプレイ
as5	フック
as6	シャンク
as7	クローズ
am1	スタッグ・ボウ
am2	リフレックス・ボウ
am3	メイデン・スピア
am4	メイデン・パイク
am5	メイデン・ジャベリン
ob6	グローイング・オーブ
ob7	クリスタリン・グローブ
ob8	クラウディ・スフィア
ob9	スパークリング・ボール
oba	スワーリング・クリスタル
am6	アッシュウッド・ボウ
am7	セレモニアル・ボウ
am8	セレモニアル・スピア
am9	セレモニアル・パイク
ama	セレモニアル・ジャベリン
obb	ヘヴンリー・ストーン
obc	エルドリッチ・オーブ
obd	デーモン・ハート
obe	ヴォーテックス・オーブ
obf	ディメンショナル・シャード
amb	メイトリアーカル・ボウ
amc	グランド・メイトロン・ボウ
amd	メイトリアーカル・スピア
ame	メイトリアーカル・パイク
amf	メイトリアーカル・ジャベリン
dr4	ファルコン・マスク
dr2	ホーク・ヘルム
dr3	アントラーズ
dr1	ウルフ・ヘッド
dr5	スピリット・マスク
ba1	ジョウボーン・キャップ
ba2	ファングド・ヘルム
ba3	ホーンド・ヘルム
ba4	アソールト・ヘルメット
ba5	アヴェンジャー・ガード
pa1	タージ
pa2	ロンダッシュ
pa3	ヘラルディック・シールド
pa4	アエリン・シールド
pa5	クラウン・シールド
ne1	プリザーブド・ヘッド
ne2	ゾンビー・ヘッド
ne3	アンラヴェラー・ヘッド
ne4	ガーゴイル・ヘッド
ne5	デーモン・ヘッド
ci0	サークレット
ci1	コロネット
ci2	ティアラ
ci3	ダイアデム
uap	シャコー
ukp	ハイドラスカル
ulm	アーメット
uhl	ジャイアント・カンク
uhm	スパイアード・ヘルム
urn	コロナ
usk	デーモンヘッド
uui	ダスク・シュラウド
uea	ワームハイド
ula	スカラブ・ハスク
utu	ワイア・フリース
ung	ダイアモンド・メイル
ucl	ロリケイティッド・メイル
uhn	ボーンウィーヴ
urs	グレイト・ホーバーク
upl	バルログ・スキン
ult	ヘルフォージ・プレート
uld	クラーケン・シェル
uth	ラッカード・プレート
uul	シャドウ・プレート
uar	セイクリッド・アーマー
utp	アルコン・プレート
uuc	ヒーター
uml	ルナ
urg	ハイペリオン
uit	モナーク
uow	イージス
uts	ウォード
ulg	ブランブル・ミッツ
uvg	ヴァンパイアボーン・グローブ
umg	ヴァンブレイシズ
utg	クルセイダー・ガントレット
uhg	オウガ・ガントレット
ulb	ワームハイド・ブーツ
uvb	スカラブシェル・ブーツ
umb	ボーンウィーヴ・ブーツ
utb	ミラード・ブーツ
uhb	ミュルミドーン・グリーヴ
ulc	スパイダーウェブ・サッシュ
uvc	ヴァンパイアファング・ベルト
umc	ミスリル・コイル
utc	トロール・ベルト
uhc	コロッサス・ガードル
uh9	ボーン・ヴィズィッジ
ush	トロール・ネスト
upk	ブレイド・バリア
dr9	セイクリッド・フェザーズ
dr7	グリフォン・ヘッドドレス
dr8	ハンターズ・ガイス
dr6	アルファ・ヘルム
dra	トーテミック・マスク
ba6	ジョウボーン・ヴァイザー
ba7	ライオン・ヘルム
ba8	レイジ・マスク
ba9	サヴェッジ・ヘルメット
baa	スレイヤー・ガード
pa6	アカラン・タージ
pa7	アカラン・ロンダッシュ
pa8	プロテクター・シールド
pa9	ギルデッド・シールド
paa	ロイヤル・シールド
ne6	マミファイド・トロフィー
ne7	フェティッシュ・トロフィー
ne8	セクストン・トロフィー
ne9	キャンター・トロフィー
nea	ハイエロファント・トロフィー
dre	スカイ・スピリット
drc	サン・スピリット
drd	アース・スピリット
drb	ブラッド・スピリット
drf	ドリーム・スピリット
bab	カーネイジ・ヘルム
bac	フューリー・ヴァイザー
bad	デストロイヤー・ヘルム
bae	コンクァラー・クラウン
baf	ガーディアン・クラウン
pab	セイクリッド・タージ
pac	セイクリッド・ロンダッシュ
pae	ザカラム・シールド
paf	ヴォーテックス・シールド
neb	ミニオン・スカル
nec	ヘルスポーン・スカル
ned	オーヴァーシーアー・スカル
nee	サキュバス・スカル
nef	ブラッドロード・スカル
AmaOnly	(アマゾンのみ)
SorOnly	(ソーサレスのみ)
NecOnly	(ネクロマンサーのみ)
PalOnly	(パラディンのみ)
BarOnly	(バーバリアンのみ)
DruOnly	(ドルイドのみ)
AssOnly	(アサシンのみ)
jew	ジュエル
hrb	ハーブ
cm1	スモール・チャーム
cm2	ラージ・チャーム
cm3	グランド・チャーム
Charmdes	所持品に入れておけば効果を発揮
ice	アーニャを救うのに使う\nマラーのポーション
r33	ゾッド・ルーン
r32	チャム・ルーン
r31	ジョー・ルーン
r30	バー・ルーン
r29	サー・ルーン
r28	ロー・ルーン
r27	オーム・ルーン
r26	ヴェックス・ルーン
r25	グル・ルーン
r24	イスト・ルーン
r23	マル・ルーン
r22	ウム・ルーン
r21	プル・ルーン
r20	レム・ルーン
r19	ファル・ルーン
r18	コー・ルーン
r17	ルム・ルーン
r16	ポー・ルーン
r15	ヘル・ルーン
r14	ドル・ルーン
r13	シャエ・ルーン
r12	ソル・ルーン
r11	アムン・ルーン
r10	スル・ルーン
r09	オート・ルーン
r08	ラル・ルーン
r07	タル・ルーン
r06	イス・ルーン
r05	エス・ルーン
r04	ネフ・ルーン
r03	ティル・ルーン
r02	エルド・ルーン
r01	エル・ルーン
r33L	ゾッド
r32L	チャム
r31L	ジョー
r30L	バー
r29L	サー
r28L	ロー
r27L	オーム
r26L	ヴェックス
r25L	グル
r24L	イスト
r23L	マル
r22L	ウム
r21L	プル
r20L	レム
r19L	ファル
r18L	コー
r17L	ルム
r16L	ポー
r15L	ヘル
r14L	ドル
r13L	シャエ
r12L	ソル
r11L	アムン
r10L	スル
r09L	オート
r08L	ラル
r07L	タル
r06L	イス
r05L	エス
r04L	ネフ
r03L	ティル
r02L	エルド
r01L	エル
RuneQuote	'
Runeword1	古き民の免状
Runeword2	アーマゲドン
Runeword3	オーソリティ
Runeword4	ビースト
Runeword5	ビューティー
Runeword6	ブラック
Runeword7	ブラッド
Runeword8	ボーン
Runeword9	ブランブル
Runeword10	ブランド
Runeword11	ブレス・オヴ・ザ・ダイイング
Runeword12	ブロークン・プロミス
Runeword13	コール・トゥ・アームズ
Runeword14	チェインズ・オヴ・オナー
Runeword15	チャンス
Runeword16	ケイオス
Runeword17	クレッセント・ムーン
Runeword18	ダークネス
Runeword19	デイライト
Runeword20	デスリー・ヴィザージュ
Runeword21	ディセプション
Runeword22	ディリリアム
Runeword23	ディザイア
Runeword24	ディスペア
Runeword25	ディストラクション
Runeword26	ドゥーム
Runeword27	ドラゴン
Runeword28	ドレッド
Runeword29	ドリーム
Runeword30	ドゥレス
Runeword31	エッジ
Runeword32	イレイション
Runeword33	エニグマ
Runeword34	エンライトメント
Runeword35	エンヴィー
Runeword36	エターニティ
Runeword37	エグザイル
Runeword38	フェイス
Runeword39	ファミン
Runeword40	フレイム
Runeword41	フォーティテュード
Runeword42	フォーチュン
Runeword43	フレンドシップ
Runeword44	フューリー
Runeword45	グルーム
Runeword46	グローリー
Runeword47	グリーフ
Runeword48	ハンド・オヴ・ジャスティス
Runeword49	ハーモニー
Runeword50	ヘイトレッド
Runeword51	ハート・オヴ・ジ・オーク
Runeword52	ヘヴンズ・ウィル
Runeword53	ホーリー・ティアーズ
Runeword54	ホーリー・サンダー
Runeword55	オナー
Runeword56	リベンジ
Runeword57	ヒューミリティ
Runeword58	ハンガー
Runeword59	アイス
Runeword60	インフィニティ
Runeword61	イノセンス
Runeword62	インサイト
Runeword63	ジェラシー
Runeword64	ジャッジメント
Runeword65	キングズ・グレイス
Runeword66	キングスレイヤー
Runeword67	ナイツ・ヴィジル
Runeword68	ナリッジ
Runeword69	ラスト・ウィッシュ
Runeword70	ロー
Runeword71	ローブリンガー
Runeword72	リーフ
Runeword73	ライトニング
Runeword74	ライオンハート
Runeword75	ロアー
Runeword76	ラヴ
Runeword77	ロイヤリティ
Runeword78	ラスト
Runeword79	マッドネス
Runeword81	マリス
Runeword82	メロディ
Runeword83	メモリー
Runeword84	ミスト
Runeword85	モーニング
Runeword86	ミステリー
Runeword87	ミス
Runeword88	ネイディア
Runeword89	ネイチャーズ・キングダム
Runeword90	ナイト
Runeword91	オース
Runeword92	オビーディアンス
Runeword93	オブリヴィオン
Runeword94	オブセッション
Runeword95	パッション
Runeword96	ペイシャンス
Runeword97	パター
Runeword98	ピース
Runeword99	ヴォイス・オヴ・リーズン
Runeword100	ペニテンス
Runeword101	ペリル
Runeword102	ペスティレンス
Runeword103	フェニックス
Runeword104	パイエティ
Runeword105	ピラー・オヴ・フェイス
Runeword106	プラーグ
Runeword107	プレイズ
Runeword108	プレイアー
Runeword109	プライド
Runeword110	プリンシプル
Runeword111	プラウアス・イン・バトル
Runeword112	プルーデンス
Runeword113	パニッシュメント
Runeword114	ピュアリティ
Runeword115	クエスチョン
Runeword116	レイディアンス
Runeword117	レイン
Runeword118	リーズン
Runeword119	レッド
Runeword120	ライム
Runeword121	リフト
Runeword122	サンクチュアリ
Runeword123	セレンディピティ
Runeword124	シャドウ
Runeword125	シャドウ・オヴ・ダウト
Runeword126	サイレンス
Runeword127	サイレンズ・ソング
Runeword128	スモーク
Runeword129	ソロウ
Runeword130	スピリット
Runeword131	スプレンダー
Runeword132	スターライト
Runeword133	ステルス
Runeword134	スティール
Runeword135	スティル・ウォーター
Runeword136	スティング
Runeword137	ストーン
Runeword138	ストーム
Runeword139	ストレングス
Runeword140	テンペスト
Runeword141	テンプテーション
Runeword142	テラー
Runeword143	サースト
Runeword144	ソート
Runeword145	サンダー
Runeword146	タイム
Runeword147	トラディション
Runeword148	トリーチャリー
Runeword149	トラスト
Runeword150	トゥルース
Runeword151	アンベンディング・ウィル
Runeword152	ヴァラー
Runeword153	ヴェンジャンス
Runeword154	ヴェノム
Runeword155	ヴィクトリー
Runeword156	ヴォイス
Runeword157	ヴォイド
Runeword158	ウォー
Runeword159	ウォーター
Runeword160	ウェルス
Runeword161	ウィスパー
Runeword162	ホワイト
Runeword163	ウィンド
Runeword164	ウィングズ・オヴ・ホープ
Runeword165	ウィズダム
Runeword166	ウォウ
Runeword167	ワンダー
Runeword168	ラス
Runeword169	ユース
Runeword170	ゼフィール
spe	スプリーン
scz	スカルプ
sol	ソウル
qll	クィル
fng	ファング
flg	フラッグ
tal	テイル
hrn	ホーン
eyz	アイ
jaw	ジョウボーン
brz	ブレイン
hrt	ハート
Stout	丈夫な
Antimagic	耐魔法の
Null	無意味の
Godly	神の
Ivory	象牙の
Eburin	白皙の
Blanched	漂白されし
Stalwart	堅牢なる
Burly	たくましき
Dense	高密度の
Thin	薄い
Compact	コンパクトな
Witch-hunter's	ウィッチハンターの
Magekiller's	メイジキラーの
Hierophant's	ハイエロファントの
Shaman's	シャーマンの
Pestilent	伝染病の
Toxic	有毒の
Corosive	腐食性の
Envenomed	汚れし
Septic	敗血症の
Shocking	感電の
Arcing	放電の
Buzzing	通電の
Static	空電の
Scorching	蓄電の
Flaming	火炎の
Smoking	煙の
Smoldering	くすぶる
Ember	燃える
Hibernal	寒冷の
Boreal	寒帯の
Shivering	凍てつく
Snowflake	雪の
Mnemonic	記憶の
Visionary	直観の
Eagleeye	鷲の目の
Hawkeye	鷹の目の
Falconeye	隼の目の
Sparroweye	雀の目の
Robineye	駒鳥の目の
Paradox	逆説の
Shouting	咆吼する
Yelling	怒号の
Calling	喊声の
Loud	警告の
Trump	愚者の
Joker's	ジョーカーの
Jester's	道化師の
Jack's	ジャックの
Knave's	悪漢の
Paleocene	敬虔なる
Eocene	正義の
Oligocene	名誉の
Miocene	光明の
Kenshi's	剣士の
Sensei's	先生の
Shogukusha's	ショーグクシャの
Psychic	サイキックの
Mentalist's	読心術師の
Cunning	狡猾なる
Trickster's	トリックスターの
Entrapping	トラップの
Gaea's	ガイアの
Terra's	大地の
Nature's	自然の
Communal	コミューンの
Feral	野生の
Spiritual	精霊の
Keeper's	番人の
Caretaker's	管理人の
Trainer's	トレーナーの
Veteran's	ベテランの
Expert's	エキスパートの
Furious	激怒の
Raging	憤怒の
Echoing	こだまの
Resonant	共鳴の
Sounding	鳴り渡る
Guardian's	守護者の
Warder's	監視員の
Preserver's	保護者の
Marshal's	元帥の
Commander's	司令官の
Captain's	キャプテンの
Rose Branded	薔薇の印の
Hawk Branded	鷹の印の
Lion Branded	獅子の印の
Golemlord's	ゴーレムロードの
Vodoun	モジョーの
Graverobber's	墓荒らしの
Venomous	毒素の
Noxious	毒性の
Fungal	菌性の
Accursed	呪縛の
Blighting	疾病の
Hexing	魔術の
Glacial	氷河の
Freezing	凍結の
Chilling	極寒の
Powered	パワーの
Charged	チャージの
Sparking	火花を放つ
Volcanic	火山の
Blazing	燃えさかる
Burning	灼熱の
Lancer's	ランサーの
Spearmaiden's	スピアメイデンの
Harpoonist's	ハープニストの
Athlete's	アスレチックの
Gymnast's	体術の
Acrobat's	アクロバットの
Bowyer's	射手の
Diamond	ダイアモンドの
Celestial	天界の
Elysian	楽園の
Astral	天上の
Unearthly	この世ならざる
Arcadian	アルカディアの
Jeweler's	宝石職人の
Artificer's	名工の
Mechanist's	機械技師の
Aureolin	後光の
Victorious	勝利の
Ambergris	竜涎香の
Camphor	カンフルの
Lapis Lazuli	ラピスラズリの
Chromatic	色彩の
Scintillating	閃光の
Turquoise	ターコイズの
Jacinth	ヒヤシンス石の
Zircon	ジルコニアの
Bahamut's	バハムートの
Great Wyrm's	グレイト・ワームの
Felicitous	僥倖の
Lucky	天運の
Wailing	絶叫の
Screaming	悲鳴の
Grandmaster's	グランドマスターの
Master's	マスターの
Argent	白銀の
Tin	錫の
Nickel	ニッケルの
Maroon	マルーンの
Chestnut	栗色の
Vigorous	快活なる
Brown	ブラウンの
Dun	灰褐色の
Realgar	鶏冠石の
Rusty	錆色の
Cinnabar	シナバーの
Vermillion	朱の
Carmine	カーマインの
Carbuncle	カーバンクルの
Serrated	ギザギザの
Scarlet	緋色の
Bloody	鮮血の
Sanguinary	流血の
Pearl	真珠の
Divine	神授の
Hallowed	天恵の
Sacred	神聖な
Pure	純粋なる
Consecrated	聖別されたる
Assamic	月の
Frantic	狂乱の
Hellatial	地獄のごとき
Quixotic	気宇壮大の
Smiting	殴打の
Steller	恒星の
Stinging	刺激の
Singing	歌う
Timeless	永久の
Original	根元の
Corporal	現世の
Lawful	秩序の
Chaotic	混沌の
Fierce	猛々しき
Ferocious	獰猛なる
Perpetual	永続の
Continuous	終わりなき
Laden	感染の
Pernicious	悪性の
Harmful	有害なる
Evil	邪悪なる
Insidious	奸智の
Malicious	敵意の
Spiteful	陰険な
Precocious	早熟の
Majestic	荘厳なる
Sanguine	血気盛んな
Monumental	不滅の
Irresistible	あらがい得ぬ
Festering	化膿を誘う
Musty	黴を呼ぶ
Dusty	塵芥の
Decaying	朽ちた
Rotting	腐乱の
Infectious	汚染の
Foggy	霧の
Cloudy	曇天の
Hazy	雲霞の
Punishing	天誅の
Obsidian	黒曜石の
Royal	王家の
Frigid	厳寒の
Moldy	かびた
Gaudy	派手な
Impecable	完璧の
Soulless	魂なき
Heated	白熱の
Lasting	永遠の
Scorched	燃え残りの
Marred	傷物の
Lilac	ライラック色の
Rose	薔薇色の
Shimmering	輝く
Green	緑の
Wicked	よこしまなる
Strange	風変わりな
Repulsive	反発の
Reclusive	隠者の
Crude	粗雑な
Rude	粗野な
Hermetic	錬金術の
Rainbow	虹の
Colorful	多彩なる
Stinky	臭気の
Gritty	研削の
of Warming	(暖気)
of Stoicism	(節制)
of the Dynamo	(ダイナモ)
of Grounding	(グラウンディング)
of Insulation	(絶縁)
of Resistance	(耐性)
of Faith	(信仰)
of Fire Quenching	(無効)
of Amianthus	(石綿)
of Incombustibility	(可燃)
of Coolness	(寒冷)
of Anima	(友好)
of Life Everlasting	(不死)
of Sunlight	(陽光)
of Frozen Orb	(フローズン・オーブ)
of Hydra Shield	(ハイドラ・シールド)
of Chilling Armor	(チリング・アーマー)
of Blizzard	(ブリザード)
of Energy Shield	(エナジー・シールド)
of Thunder Storm	(サンダー・ストーム)
of Meteor	(メテオ)
of Glacial Spike	(グラシアル・スパイク)
of Teleport Shield	(テレポート・シールド)
of Chain Lightning	(チェイン・ライトニング)
of Enchant	(エンチャント)
of Fire Wall	(ファイア・ウォール)
of Shiver Armor	(シヴァー・アーマー)
of Nova Shield	(ノヴァ・シールド)
of Nova	(ノヴァ)
of Fire Ball	(ファイア・ボール)
of Blaze	(ブレイズ)
of Ice Blast	(アイス・ブラスト)
of Frost Shield	(フロスト・シールド)
of Telekinesis	(テレキネシス)
of Static Field	(スタティック・フィールド)
of Frozen Armor	(フローズン・アーマー)
of Icebolt	(アイスボルト)
of Charged Shield	(チャージド・ボルト)
of Firebolts	(ファイア・ボルト)
of the Elements	(エレメント)
of the Cobra	(コブラ)
of the Efreeti	(イフリート)
of the Phoenix	(フェニックス)
of the Yeti	(イェティ)
of Grace and Power	(高雅と力)
of Grace	(高雅)
of Power	(力)
of the Elephant	(象)
of Memory	(記憶)
of the Kraken1	(クラーケン)
of Propogation	(増殖)
of Replenishing	(補充)
of Ages	(年輪)
of Fast Repair	(復旧)
of Self-Repair	(自己修復)
of Acceleration	(加速)
of Traveling	(輸送)
of Virility	(精力)
of Atlus	(アトラス)
of Freedom	(自由)
of the Lamprey	(ランプリー)
of Hope	(希望)
of Spirit	(意気)
of Vita	(命)
of Substinence	(維持)
of the Whale	(鯨)
of the Squid	(烏賊)
of the Colossus1	(コロッサス)
of Knowledge	(知識)
of Enlightenment	(啓蒙)
of Prosperity	(繁栄)
of Good Luck	(強運)
of Luck	(運気)
of Avarice	(強欲)
of Honor	(名誉)
of Revivification	(復活)
of Truth	(真実)
of Daring	(剛胆)
of Nirvana	(涅槃)
of Envy	(羨望)
of Anthrax	(炭疽)
of Bliss	(至福)
of Joy	(歓喜)
of Transcendence	(秀逸)
of Wrath	(憤激)
of Ire	(憤懣)
of Evisceration	(破砕)
of Butchery	(殺生)
of Ennui	(倦怠)
of Storms	(大嵐)
of Passion	(熱情)
of Incineration	(焼尽)
of Frigidity	(極寒)
of Winter	(冬)
of the Icicle	(つらら)
of Fervor	(熱気)
of Malice	(敵意)
of Swords	(ソード)
of Razors	(剃刀)
of Desire	(欲望)
of the Sirocco	(シロッコ)
of the Dunes	(砂丘)
of Thawing	(解氷)
Of the Choir	(聖歌)
Of the Sniper	(狙撃)
Of the Stiletto	(スティレット)
Of Bile	(癇気)
Of Blitzen	(電撃)
Of Cremation	(火葬)
Of Darkness	(暗黒)
Of Disease	(疾患)
Of Remorse	(悔恨)
Of Terror	(脅怖)
Of the Sky	(蒼天)
Of Valhalla	(ヴァルハラ)
Of Waste	(荒廃)
Of Nobility	(高貴)
Of Karma	(カルマ)
Of Grounding	(グラウンディング)
Of the River	(大河)
Of the Lake	(湖沼)
Of the Ocean	(大洋)
Of the Bayou	(緩流)
Of the Stream	(流水)
Of the Lady	(貴婦人)
Of the Maiden	(乙女)
Of the Virgin	(処女)
Of the Hag	(老婆)
Of the Witch	(魔女)
Of Judgement	(審判)
Of Illusion	(幻影)
Of Elusion	(回避)
Of Combat	(戦闘)
Of Attrition	(消耗)
Of Abrasion	(摩耗)
Of Erosion	(腐蝕)
Of Searing	(炎熱)
Of Stone	(巌石)
Of Stature	(有徳)
Of Fortication	(防壁)
Of Quickening	(促進)
Of Dispatch	(至急)
Of Daring	(剛胆)
Of Dread	(怯え)
Of Suffering	(苦難)
Of Doom	(破滅)
Of Vengence	(復讐)
Of Redemption	(報復)
Of Luck	(運気)
Of the Avenger	(報復者)
Of the Specter	(亡霊)
Of the Ghost	(ゴースト)
Of the Infantry	(歩兵)
Of the Mosquito	(蚊)
Of the Gnat	(虻)
Of the Fly	(蠅)
Of the Plague	(疫病)
Of Twilight	(黄昏)
Of Dusk	(薄暮)
Of Dawn	(曙)
Of the Imbecile	(愚鈍)
Of the Idiot	(痴者)
Of the Retard	(魯鈍)
Of the Jujube	(棗)
Of the Obscenity	(不徳)
Of Quota	(分配)
Of the Maggot	(マゴット)
Of Horror	(恐怖)
Of Baddass	(深淵)
Of the Beast	(野獣)
Of Cruelty	(残酷)
Of Badness	(バッドネス)
Of the Horde	(略奪)
Of the Forest	(森林)
Of the Lilly	(百合)
Of the Grassy Gnoll	(グラッシー・ノール)
Of the Stars	(星)
Of the Moon	(月)
Of Love	(愛)
Of the Unicorn	(ユニコーン)
Of the Walrus	(セイウチ)
Of the Earth	(地球)
Of Vines	(蔦)
Of Honor	(名誉)
Of Tribute	(賛辞)
Of Credit	(信望)
Of Admiration	(絶賛)
Of Sweetness	(柔和)
Of Beauty	(優美)
Of Pilfering	(窃盗)
of Damage Amplification	(アンプリファイ・ダメージ)
of Hurricane	(ハリケーン)
of Armageddon	(アーマゲドン)
of Tornado	(トーネイド)
of Volcano	(ヴォルケイノ)
of Twister	(ツイスター)
of Cyclone Armor	(サイクロン・アーマー)
of Eruption	(フィシュア)
of Molten Boulders	(モルテン・ボールダー)
of Firestorms	(ファイアストーム)
of Battle Command	(バトルコマンド)
of War Cry	(ウォー・クライ)
of Grim Ward	(グリム・ウォード)
of Battle Orders	(バトル・オーダー)
of Battle Cry	(バトル・クライ)
of Concentration	(コンセントレイション)
of Item Finding	(ファインド・アイテム)
of Stunning	(スタン)
of Shouting	(シャウト)
of Taunting	(トーント)
of Potion Finding	(ファインド・ポーション)
of Howling	(ハウル)
of Fist of the Heavens	(フィスト・オヴ・ザ・ヘヴンズ)
of Holy Shield	(ホーリー・シールド)
of Conversion	(コンヴァージョン)
of Blessed Hammers	(ブレスト・ハンマー)
of Vengeance	(ヴェンジャンス)
of Charging	(チャージ)
of Zeal	(ジール)
of Holy Bolts	(ホーリー・ボルト)
of Sacrifice	(サクリファイス)
of Fire Golem Summoning	(ファイア・ゴーレム)
of Bone Spirits	(ボーン・スピリット)
of Poison Novas	(ポイズン・ノヴァ)
of Lower Resistance	(ロウアー・レジスト)
of Iron Golem Creation	(アイアン・ゴーレム)
of Bone Imprisonment	(ボーン・プリズン)
of Decrepification	(ディクレピファイ)
of Attraction	(アトラクト)
of Blood Golem Summoning	(ブラッド・ゴーレム)
of Bone Spears	(ボーン・スピア)
of Poison Explosion	(ポイズン・エクスプロージョン)
of Life Tap	(ライフ・タップ)
of Confusion	(コンフュージョン)
of Raise Skeletal Mages	(スケルトン・メイジ)
of Bone Walls	(ボーン・ウォール)
of Terror	(テラー)
of Iron Maiden	(アイアン・メイデン)
of Clay Golem Summoning	(クレイ・ゴーレム)
of Corpse Explosions	(コープス・エクスプロージョン)
of Poison Dagger	(ポイズン・ダガー)
of Weaken	(ウィークン)
of Dim Vision	(ディム・ビジョン)
of Raise Skeletons	(レイズ・スケルトン)
of Bone Armor	(ボーン・アーマー)
of Teeth	(ティース)
of Amplify Damage	(アンプリファイ・ダメージ)
of Frozen Orbs	(フローズン・オーブ)
of Hydras	(ヒュドラ)
of Blizzards	(ブリザード)
of Meteors	(メテオ)
of Glacial Spikes	(グラシアル・スパイク)
of Teleportation	(テレポーテーション)
of Enchantment	(エンチャントメント)
of Fire Walls	(ファイア・ウォール)
of Novas	(ノヴァ)
of Fire Balls	(ファイア・ボール)
of Blazing	(ブレイジング)
of Ice Blasts	(アイス・ブラスト)
of Frost Novas	(フロスト・ノヴァ)
of Ice Bolts	(アイス・ボルト)
of Charged Bolts	(チャージド・ボルト)
of Fire Bolts	(ファイア・ボルト)
of Lightning Fury	(ライトニング・フューリー)
of Lightning Spear	(ライトニング・スピア)
of Freezing Arrows	(フリージング・アロー)
of Fending	(フェンド)
of Immolating Arrows	(イモレイション・アロー)
of Plague Javelin	(プラーグ・ジャベリン)
of Charged Spear	(チャージド・スピア)
of Guided Arrows	(ガイデッド・アロー)
of Ice Arrows	(アイス・アロー)
of Lightning Javelin	(ライトニング・ジャベリン)
of Impaling Spear	(インペイリング・スピア)
of Slow Missiles	(スロー・ミサイル)
of Exploding Arrows	(エクスプローディング・アロー)
of Poison Javelin	(ポイズン・ジャベリン)
of Power Spear	(パワー・スピア)
of Multiple Shot	(マルチプル・ショット)
of Cold Arrows	(コールド・アロー)
of Jabbing	(ジャブ)
of Inner Sight	(インナー・サイト)
of Fire Arrows	(ファイア・アロー)
of Magic Arrows	(マジック・アロー)
Of self-repair	自己修復
of Dawn	(曙)
of Inertia	(慣性)
of Joyfulness	(歓楽)
ModStre8a	、ドルイドのスキルレベル修正
ModStre8b	、ドルイドのスキルレベル修正
ModStre8c	個のソケット
ModStre8d	、対デーモン攻撃値修正
ModStre8e	、対アンデッド攻撃値修正
ModStre8f	、対デーモンダメージ修正
ModStre8g	％、攻撃値修正
ModStre8h	、ジャベリンとスピアのスキルレベル修正
ModStre8i	、パッシブと魔法のスキルレベル修正
ModStre8j	、弓とクロスボウのスキルレベル修正
ModStre8k	、防御のオーラのスキルレベル修正
ModStre8l	、攻撃のオーラのスキルレベル修正
ModStre8m	、戦闘のスキルレベル修正
ModStre8n	、召喚のスキルレベル修正
ModStre8o	、毒物と骨のスキルレベル修正
ModStre8p	(呪いスキル)
ModStre8q	、雄叫びのスキルレベル修正
ModStre8r	、戦闘のスキルレベル修正
ModStre8s	、戦闘の極意のスキルレベル修正
ModStre8t	、冷気のスキルレベル修正
ModStre8u	、稲妻のスキルレベル修正
ModStre8v	、火炎のスキルレベル修正
ModStre8w	、召喚呪文のスキルレベル修正
ModStre8x	、変身のスキルレベル修正
ModStre8y	、エレメンタルのスキルレベル修正
ModStre8z	、トラップのスキルレベル修正
ModStre9a	、シャドウ・ディシプリンのスキルレベル修正
ModStre9b	、マーシャル・アーツのスキルレベル修正
ModStre9c	(キャラクターレベルに比例)
ModStre9d	(夜間に上昇)
ModStre9e	(昼間に上昇)
ModStre9f	(夜明け前後に上昇)
ModStre9g	(夕暮れ前後に上昇)
ModStre9h	チャージの
ModStre9i	スタック数増加
ModStre9s	破壊不能
ModStre9t	１秒ごとに%dの耐久力を自然修復
ModStre9u	%dずつ耐久力を自然修復／%d秒ごとに
ModStre9v	数量が徐々に回復
ModStre9w	レベル%dの呪文投射：
ModStre9x	(振るうごとに)
ModStre9y	(敵の攻撃を受けるごとに)
ModStre9z	(敵に攻撃を当てるごとに)
ModStre10a	回分のチャージ
ModStre10b	レベル
ModStre10c	（１レベルにつき）
ModStre10d	(%d/%d回分のチャージ)
ModStre10e	(
ModStre10f	)
ModStre10g	ステルス
ModStre10h	毒物を受け付けない
ModStre10i	呪われている
ModStre10j	（パーティのプレイヤー１人あたり）
WeaponDescH2H	クロー級
WeaponDescOrb	オーブ級
ItemexpED	エレメンタル・ダメージ
StrGemX1	兜：
StrGemX2	盾：
StrGemX3	武器：
StrGemX4	防具：
GemeffectX11	筋力に追加
GemeffectX12	防御値に追加
GemeffectX13	攻撃値に追加
GemeffectX21	最大マナに追加
GemeffectX22	冷気耐性に追加
GemeffectX23	攻撃に冷気ダメージを追加
GemeffectX31	敏捷性に追加
GemeffectX32	毒物耐性に追加
GemeffectX33	攻撃に毒物ダメージを追加
GemeffectX41	最大ライフに追加
GemeffectX42	火炎耐性に追加
GemeffectX43	攻撃に火炎ダメージを追加
GemeffectX51	攻撃値に追加
GemeffectX52	全耐性に追加
GemeffectX53	対アンデッドダメージに追加
GemeffectX61	マジックアイテム発見確率に追加
GemeffectX62	稲妻耐性に追加
GemeffectX63	攻撃に稲妻ダメージを追加
GemeffectX71	マナとライフの回復を追加
GemeffectX72	攻撃者にダメージを返す性質を追加
GemeffectX73	攻撃の際にマナとライフを盗む性質を追加
Coldkill	コールドキル
Butchers Cleaver	ブッチャーズ・クリーヴァー
Butcher's Pupil	ブッチャーズ・ピューピル
Islestrike	アイルストライク
Pompe's Wrath	ポンペイズ・ラス
Guardian Naga	ガーディアン・ナーガ
Warlord's Trust	ウォーローズ・トラスト
Spellsteel	スペルスティール
Stormrider	ストームライダー
Boneslayer Blade	ボーンスレイヤー・ブレイド
The Minotaur	ザ・ミノタウル
Suicide Branch	スイサイド・ブランチ
Cairn Shard	ケルン・シャード
Arm of King Leoric	アーム・オヴ・キング・レオリック
Blackhand Key	ブラックハンド・キー
Dark Clan Crusher	ダーク・クラン・クラッシャー
Drulan's Tongue	ドルランズ・タン
Zakrum's Hand	ザカラムズ・ハンド
The Fetid Sprinkler	ザ・フェティッド・スプリンクラー
Hand of Blessed Light	ハンド・オヴ・ブレスト・ライト
Fleshrender	フレッシュレンダー
Sureshrill Frost	シュアシュリル・フロスト
Moonfall	ムーンフォール
Baezils Vortex	ベイジルズ・ヴォーテックス
Earthshaker	アースシェイカー
Bloodtree Stump	ブラッドツリー・スタンプ
The Gavel of Pain	ザ・ガヴル・オヴ・ペイン
Bloodletter	ブラッドレッター
Coldsteal Eye	コールドスティール・アイ
Hexfire	ヘックスファイア
Blade of Ali Baba	ブレイド・オヴ・アリ・ババ
Riftslash	リフトスラッシュ
Headstriker	ヘッドストライカー
Plague Bearer	プラーグ・ベアラー
The Atlantien	ジ・アトランティアン
Crainte Vomir	クラント・ヴォミール
Bing Sz Wang	ビン・ス・ワン
The Vile Husk	ザ・ヴァイル・ハスク
Cloudcrack	クラウドクラック
Todesfaelle Flamme	トデスフェイレ・フラメ
Swordguard	ソードガード
Spineripper	スパインリッパー
Heart Carver	ハート・カーヴァー
Blackbog's Sharp	ブラックドッグズ・シャープ
Stormspike	ストームスパイク
The Impaler	ジ・インペイラー
Kelpie Snare	ケルピー・スネア
Soulfeast Tine	ソウルフィースト・タイン
Hone Sundan	ホーン・スンダン
Spire of Honor	スパイア・オヴ・オナー
The Meat Scraper	ザ・ミート・スクレイパー
Blackleach Blade	ブラックリーチ・ブレイド
Athena's Wrath	アシーナズ・ラス
Pierre Tombale Couant	ピエール・トンバル・クーシャン
Husoldal Evo	フソルダル・エヴォ
Grim's Burning Dead	グリムズ・バーニング・デッド
Ribcracker	リブクラッカー
Chromatic Ire	クロマティック・アイア
Warpspear	ウォープスピア
Skullcollector	スカル・コレクター
Skystrike	スカイストライク
Kuko Shakaku	クコ・シャカク
Endlessshail	エンドレスヘイル
Whichwild String	ホィッチワイルド・ストリング
Godstrike Arch	ゴールドストライク・アーチ
Langer Briser	ランゲル・ブリセル
Pus Spiter	パス・スピッター
Buriza-Do Kyanon	ブリザード・キャノン
Vampiregaze	ヴァンパイア・ゲイズ
String of Ears	ストリング・オヴ・イヤーズ
Gorerider	ゴア・ライダー
Lavagout	ラヴァ・ガウト
Venom Grip	ヴェノム・グリップ
Visceratuant	ヴィセラトゥアント
Guardian Angle	ガーディアン・エンジェル
Shaftstop	シャフトストップ
Skin of the Vipermagi	スキン・オヴ・ザ・ヴァイパーマギ
Blackhorn	ブラックホーン
Valkiry Wing	ヴァルキリー・ウィング
Peasent Crown	ペザント・クラウン
Demon Machine	デーモン・マシーン
Magewrath	メイジラス
Cliffkiller	クリフキラー
Riphook	リップフック
Razorswitch	レイザースイッチ
Meatscrape	ミートスクレイプ
Coldsteel Eye	コールドスティール・アイ
Pitblood Thirst	ピットブラッド・サースト
Gaya Wand	ガヤ・ワンド
Ondal's Wisdom	オンダルズ・ウィズダム
Geronimo's Fury	ジェロニモズ・フューリー
Charsi's Favor	チャルシズ・フェイヴァー
Doppleganger's Shadow	ドッペルゲンガーズ・シャドウ
Deathbit	デスビット
Warshrike	ウォーシュライク
Gutsiphon	ガット・サイフォン
Razoredge	レイザーズ・エッジ
Stonerattle	ストーン・ラットル
Marrowgrinder	マロウ・グラインダー
Gore Ripper	ゴア・リッパー
Bush Wacker	ブッシュ・ワッカー
Demonlimb	デーモン・リム
Steelshade	スティール・シェイド
Tomb Reaver	トゥーム・リーヴァー
Death's Web	デスズ・ウェブ
Gaia's Wrath	ガイアズ・ラス
Khalim's Vengance	カリムズ・ヴェンジャンス
Angel's Song	エンジェルズ・ソング
The Reedeemer	ザ・リディーマー
Fleshbone	フレッシュボーン
Odium	オウディアム
Blood Comet	ブラッド・コメット
Bonehew	ボーンヒュー
Steelrend	スティールレンド
Stone Crusher	ストーン・クラッシャー
Bul-Kathos' Might	バル・カソス・マイト
Arioc's Needle	アリオックス・ニードル
Shadowdancer	シャドウ・ダンサー
Indiego's Fancy	インディゴズ・ファンシー
Aladdin's Eviserator	アラディンズ・イヴィサレイター
Tyrael's Mercy	ティラエルズ・マーシー
Souldrain	ソウル・ドレイナー
Runemaster	ルーン・マスター
Deathcleaver	デス・クリーヴァー
Executioner's Justice	エクセキューショナーズ・ジャスティス
Wallace's Tear	ウォレスズ・ティアー
Leviathan	リヴァイアサン
The Wanderer's Blade	ザ・ワンダラーズ・ブレイド
Qual'Kek's Enforcer	クァル＝ケックス・エンフォーサー
Dawnbringer	ドーン・ブリンガー
Dragontooth	ドラゴントゥース
Wisp	ウィスプ・プロジェクター
Gargoyle's Bite	ガーゴイルズ・バイト
Lacerator	ラスレイター
Mang Song's Lesson	マン・ソンズ・レッスン
Viperfork	ヴァイパーフォーク
Blood Chalice	ブラッド・チャリス
El Espiritu	エル・エスピリトゥ
The Long Rod	ザ・ロンゲスト・ロッド
Demonhorn's Edge	デモンホーンズ・エッジ
The Ensanguinator	ジ・エンサングィネイター
The Reaper's Toll	ザ・リーパーズ・トール
Spiritkeeper	スピリット・キーパー
Hellrack	ヘルラック
Alma Negra	アルマ・ネグラ
Darkforge Spawn	ダークフォース・スポーン
Rockhew	ロックヒュー
Sankenkur's Resurrection	サンケカーズ・リザレクション
Erion's Bonehandle	エリオンズ・ボーンハンドル
The Archon Magus	ジ・アクロン・メイガス
Widow maker	ウィドウメイカー
Catgut	キャットガット
Ghostflame	ゴーストフレイム
Shadowkiller	シャドウ・キラー
Bling Bling	ブリン・ブリン
Nebucaneezer's Storm	ネブカドネザルズ・ストーム
Griffon's Eye	グリフォンズ・アイ
Eaglewind	イーグルウィンド
Windhammer	ウィンドハンマー
Thunderstroke	サンダーストローク
Giantmaimer	ジャイアント・メイマー
Demon's Arch	デーモンズ・アーチ
The Scalper	ザ・スカルパー
Bloodmoon	ブラッドムーン
Djinnslayer	ジン・スレイヤー
Cranebeak	クレインビーク
Iansang's Frenzy	イァンサンズ・フレンジー
Warhound	ウォーハウンド
Gulletwound	ガレットウーンド
Headhunter's Glory	ヘッド・ハンターズ・グローリー
Mordoc's marauder	モードックス・マローダー
Talberd's Law	タルバーズ・ロウ
Amodeus's Manipulator	アマデウス・マニピュレイター
Darksoul	ダークソウル
The Black Adder	ザ・ブラック・アダー
Earthshifter	アース・シフター
Nature's Peace	ネイチャーズ・ピース
Horazon's Chalice	ホラゾンズ・チャリス
Seraph's Hymn	セラフス・ヒム
Zakarum's Salvation	ザカラムズ・サルヴェイジョン
Fleshripper	フレッシュリッパー
Stonerage	ストーンレイジ
Blood Rain	ブラッドレイン
Horizon's Tornado	ホライゾンズ・トーネイド
Nord's Tenderizer	ノーズ・テンダライザー
Wrath of Cain	ラス・オヴ・ケイン
Siren's call	サイレンズ・コール
Jadetalon	ジェイド・タロン
Wraithfang	レイスファング
Blademaster	ブレイド・マスター
Cerebus	セレバス・バイト
Archangel's Deliverance	アークエンジェルズ・デリヴァランス
Sinblade	シンブレイド
Runeslayer	ルーン・スレイヤー
Excalibur	エクスカリバー
Fuego Del Sol	フューゴ・デル・ソル
Stoneraven	ストーンレイヴン
El Infierno	エル・インフィエルノ
Moonrend	ムーンレンド
Larzuk's Champion	ラーザックス・チャンピオン
Nightsummon	ナイトサモン
Bonescapel	ボーンスカルペル
Rabbit Slayer	ラビット・スレイヤー
Pagan's Athame	パガンズ・アタメ
The Swashbuckler	ザ・スワッシュバックラー
Kang's Virtue	カーンズ・ヴァーチュー
Snaketongue	スネイク・タン
Lifechoke	ライフチョーク
Ethereal edge	イシリアル・エッジ
Palo Grande	パロ・グランデ
Carnageleaver	カーネイジ・リーヴァー
Ghostleach	ゴースト・リーチ
Soulreaper	ソウル・リーパー
Samual's Caretaker	サミュエルズ・ケアテイカー
Hell's Whisper	ヘル・ウィスパー
The Harvester	ザ・ハーヴェスター
Raiden's Crutch	ライデンズ・クラッチ
The TreeEnt	ザ・トリーントスター
Stormwillow	ストームウィロー
Moonshadow	ムーン・シャドウ
Strongoak	ストロング・オーク
Demonweb	デーモンウェブ
Bloodraven's Charge	ブラッド・レイヴンズ・チャージ
Shadefalcon	シェイド・ファルコン
Robin's Yolk	ロビンズ・ヨーク
Glimmershred	グリマーシュレッド
Wraithflight	レイス・フライト
Lestron's Mark	レストロンズ・マーク
Banshee's Wail	バンシーズ・ウェイル
Windstrike	ウィンドストライク
Medusa's Gaze	メデューサズ・ゲイズ
Titanfist	タイタンズ・フィスト
Hadeshorn	ハデスホーン
Rockstopper	ロックストッパー
Stealskull	スティールスカル
Darksight Helm	ダークサイト・ヘルム
Crown of Thieves	クラウン・オヴ・シーヴズ
Blackhorn's Face	ブラックホーンズ・フェイス
The Spirit Shroud	ザ・スピリット・シュラウド
Skin of the Flayed One	スキン・オヴ・フレイド・ワン
Ironpelt	アイアン・ペルト
Spiritforge	スピリット・フォージ
Crow Caw	クロウ・コー
Duriel's Shell	ドゥリエルズ・シェル
Skullder's Ire	スカルダーズ・アイア
Toothrow	トゥースロウ
Atma's Wail	アトマズ・ウェイル
Black Hades	ブラック・ハデス
Corpsemourn	コープスモーン
Que-hegan's Wisdom	ケ＝ヘガンズ・ウィズダム
Moser's Blessed Circle	モーザーズ・ブレスト・サークル
Stormchaser	ストームチェイサー
Tiamat's Rebuke	ティアマッツ・リビューク
Gerke's Sanctuary	ガーケス・サンクチュアリ
Radimant's Sphere	ラダメンツ・スフィア
Gravepalm	グレイヴパーム
Ghoulhide	グールハイド
Hellmouth	ヘルマウス
Infernostride	インフェルノストライド
Waterwalk	ウォーターウォーク
Silkweave	シルクウィーヴ
Wartraveler	ウォー・トラヴェラー
Razortail	レイザーテイル
Gloomstrap	グルームズ・トラップ
Snowclash	スノークラッシュ
Thudergod's Vigor	サンダーゴッズ・ヴィガー
Lidless Wall	リッドレス・ウォール
Lanceguard	ランス・ガード
Squire's Cover	スクァイアズ・カヴァー
Boneflame	ボーンフレーム
Steelpillar	スティール・ピラー
Nightwing's Veil	ナイトウィングズ・ヴェイル
Hightower's Watch	ハイタワーズ・ウォッチ
Crown of Ages	クラウン・オヴ・エイジズ
Andariel's Visage	アンダリエルズ・ヴィズィッジ
Darkfear	ダークフィアー
Dragonscale	ドラゴンスケール
Steel Carapice	スティール・カラペイス
Ashrera's Wired Frame	アシェアラズ・ワイアード・フレーム
Rainbow Facet	レインボウ・ファセット
Ravenlore	レイヴンロア
Boneshade	ボーンシェイド
Nethercrow	ネザークロウ
Hellwarden's Husk	ヘル・ウォーデンズ・ハスク
Flamebellow	フレイムベロウ
Fathom	デスズ・ファゾム
Wolfhowl	ウルフハウル
Spirit Ward	スピリット・ウォード
Kira's Guardian	カイラズ・ガーディアン
Orumus' Robes	オーマス・ローブ
Gheed's Fortune	ギーズ・フォーチュン
The Vicar	ザ・ヴィカー
Stormlash	ストームラッシュ
Halaberd's Reign	ハラバーズ・レイン
Parkersor's Calm	パーカーサーズ・カーム
Warriv's Warder	ワリヴズ・ウォーダー
Spike Thorn	スパイク・ソーン
Dracul's Grasp	ドラクルズ・グラスプ
Frostwind	フロストウィンド
Templar's Might	テンプラーズ・マイト
Eschuta's temper	エシュタズ・テンパー
Firelizard's Talons	ファイアリザーズ・タロンズ
Sandstorm Trek	サンドストーム・タスク
Marrowwalk	マロウウォーク
Heaven's Light	ヘヴンズ・ライト
Merman's Speed	マーマンズ・スプロケット
Arachnid Mesh	アラクニッド・メッシュ
Nosferatu's Coil	ノスフェラトゥズ・コイル
Metalgird	メタライツ・ガース
Verdugo's Hearty Cord	ヴァーダンゴズ・ハーティ・コード
Sigurd's Staunch	シッガーズ・ステルス
Carrion Wind	キャリオン・ウィンド
Giantskull	ジャイアント・スカル
Ironward	アストレロンズ・アイアン・ウォード
Gillian's Brazier	ギリアンズ・ブレイザー
Drakeflame	ドレイクフレイム
Dust Storm	ダスト・ストーム
Skulltred	スカルトレッド
Alma's Reflection	アルマズ・リフレクション
Drulan's Tounge	ドルランズ・タン
Sacred Charge	セイクリッド・チャージ
Bul-Kathos	バル＝カソス
Saracen's Chance	サラセンズ・チャンス
Highlord's Wrath	ハイローズ・ラス
Raven Frost	レイヴン・フロスト
Dwarf Star	ドワーフ・スター
Atma's Scarab	アトマズ・スカラブ
Mara's Kaleidoscope	マーラズ・カレイドスコープ
Crescent Moon	クレッセント・ムーン
The Rising Sun	ザ・ライジング・サン
The Cat's Eye	ザ・キャッツ・アイ
Bul Katho's Wedding Band	バル＝カソス・ウェディング・バンド
Rings	リングズ
Metalgrid	メタルグリッド
Eschuta's temper	エシュタズ・テンパー
Stormshield	ストームシールド
Blackoak Shield	ブラックオーク・シールド
Ormus' Robes	オーマス・ローブズ
Arkaine's Valor	アーケインズ・ヴァラー
The Gladiator's Bane	ザ・グラディエイターズ・ベイン
Veil of Steel	ヴェイル・オヴ・スティール
Harlequin Crest	ハーレクイン・クレスト
Lance Guard	ランス・ガード
Kerke's Sanctuary	ガーケス・サンクチュアリ
Mosers Blessed Circle	モーザーズ・ブレスト・サークル
Que-Hegan's Wisdon	ケ＝ヘガンズ・ウィズダム
Guardian Angel	ガーディアン・エンジェル
Skin of the Flayerd One	スキン・オヴ・ザ・フレイド・ワン
Armor	アーマー
Windforce	ウィンドフォース
Eaglehorn	イーグルホーン
Gimmershred	ジマーシュレッド
Widowmaker	ウィドウメイカー
Stormspire	ストームスパイア
Naj's Puzzler	ナジズ・パズラー
Ethereal Edge	イシリアル・エッジ
Wizardspike	ウィザードスパイク
The Grandfather	ザ・グランドファーザー
Doombringer	ドゥームブリンガー
Tyrael's Might	ティラエルズ・マイト
Lightsabre	ライトセイバー
The Cranium Basher	ザ・クラニウム・バッシャー
Schaefer's Hammer	シェイファーズ・ハンマー
Baranar's Star	バラナーズ・スター
Deaths's Web	デスズ・ウェブ
Messerschmidt's Reaver	メッサーシュミッツ・リーヴァー
Hellslayer	ヘルスレイヤー
Endlesshail	エンドレスヘイル
The Atlantian	ジ・アトランティアン
Riftlash	リフトラッシュ
Baezil's Vortex	ベイジルズ・ヴォーテックス
Zakarum's Hand	ザカラムズ・ハンド
Carin Shard	カリン・シャード
The Minataur	ザ・ミノタウル
Trang-Oul's Avatar	トラン＝オウルズ・アヴァタール
Trang-Oul's Guise	トラン＝オウルズ・ガイス
Trang-Oul's Wing	トラン＝オウルズ・ウィング
Trang-Oul's Mask	トラン＝オウルズ・マスク
Trang-Oul's Scales	トラン＝オウルズ・スケールズ
Trang-Oul's Claws	トラン＝オウルズ・クローズ
Trang-Oul's Girth	トラン＝オウルズ・ガース
Natalya's Odium	ナターリャズ・オウディアム
Natalya's Totem	ナターリャズ・トーテム
Natalya's Mark	ナターリャズ・マーク
Natalya's Shadow	ナターリャズ・シャドウ
Natalya's Soul	ナターリャズ・ソウル
Griswold's Legacy	グリスワルズ・レガシー
Griswolds's Redemption	グリスワルズ・リデンプション
Griswold's Honor	グリスワルズ・オナー
Griswold's Heart	グリスワルズ・ハート
Griswold's Valor	グリスワルズ・ヴァラー
Tang's Imperial Robes	タンズ・インペリアル・ローブズ
Tang's Fore-Fathers	タンズ・フォア・ファーザーズ
Tang's Rule	タンズ・ルール
Tang's Throne	タンズ・スローン
Tang's Battle Standard	タンズ・バトル・スタンダード
Ogun's Fierce Visage	オーガンズ・フィアース・ヴィズィッジ
Ogun's Shadow	オーガンズ・シャドウ
Ogun's Lash	オーガンズ・ラッシュ
Ogun's Vengeance	オーガンズ・ヴェンジャンス
Bul-Kathos' Warden	バル＝カソス・ウォーデン
Bul-Kathos' Children	バル＝カソス・チルドレン
Bul-Kathos' Sacred Charge	バル＝カソス・セイクリッド・チャージ
Bul-Kathos' Tribal Guardian	バル＝カソス・トライバル・ガーディアン
Bul-Kathos' Custodian	バル＝カソス・カストーディアン
Flowkrad's Howl	フロークラッズ・ハウル
Flowkrad's Grin	フロークラッズ・グリン
Flowkrad's Fur	フロークラッズ・ファー
Flowkrad's Paws	フロークラッズ・ポウズ
Flowkrad's Sinew	フロークラッズ・シニュー
Aldur's Watchtower	オルダーズ・ウォッチタワー
Aldur's Stony Gaze	オルダーズ・ストーニィ・ゲイズ
Aldur's Deception	オルダーズ・ディセプション
Aldur's Guantlet	オルダーズ・ガントレット
Aldur's Advance	オルダーズ・アドバンス
M'avina's Battle Hymn	マヴィーナズ・バトル・ヒム
M'avina's True Sight	マヴィーナズ・トゥルー・サイト
M'avina's Embrace	マヴィーナズ・エンブレイス
M'avina's Icy Clutch	マヴィーナズ・アイシー・クラッチ
M'avina's Tenet	マヴィーナズ・テネット
M'avina's Caster	マヴィーナズ・キャスター
Sazabi's Grand Tribute	サザビーズ・グランド・トリビュート
Sazabi's Cobalt Redeemer	サザビーズ・コバルト・リディーマー
Sazabi's Ghost Liberator	サザビーズ・ゴースト・リベレイター
Sazabi's Mental Sheath	サザビーズ・メンタル・シース
Hwanin's Majesty	フワニンズ・マジェスティ
Hwanin's Justice	フワニンズ・ジャスティス
Hwanin's Splendor	フワニンズ・スプレンダー
Hwanin's Refuge	フワニンズ・レフュージ
Hwanin's Cordon	フワニンズ・コードン
The Disciple	ザ・ディシプル
Telling of Beads	テリング・オヴ・ビーズ
Laying of Hands	レイイング・オヴ・ハンズ
Rite of Passage	ライト・オヴ・パッセイジ
Spiritual Custodian	ダーク・アドヒレント
Credendum	クリデンダム
Cow King's Leathers	カウ・キングズ・レザーズ
Cow King's Horns	カウ・キングズ・ホーンズ
Cow King's Hide	カウ・キングズ・ハイド
Cow King's Hoofs	カウ・キングズ・フーヴズ
Aragon's Masterpiece	アラゴンズ・マスターピース
Aragon's Sunfire	アラゴンズ・サンファイア
Aragon's Icy Stare	アラゴンズ・アイシー・ステア
Aragon's Storm Cloud	アラゴンズ・ストーム・クラウド
Orphan's Call	オーファンズ・コール
Guillaume's Face	ギョームズ・フェイス
Willhelm's Pride	ヴィルヘルムズ・プライド
Magnus' Skin	マグナス・スキン
Wihtstan's Guard	ウィットスタンズ・ガード
Titan's Revenge	タイタンズ・リヴェンジ
Shakabra's Crux	シャカブラズ・クラックス
Lycander's Aim	ライサンダーズ・エイム
Shadow's Touch	シャドウ・タッチ
The Prowler	ザ・プラウラー
Mortal Crescent	モータル・クレッセント
Cutthroat	バータックス・チョプチョプ
Sarmichian Justice	サムライ・ジャスティス
Annihilus	アナイアラス
Arreat's Face	アリーツ・フェイス
The Harbinger	ザ・ハービンジャー
Doomseer	ドゥームシーアー
Howling Visage	ハウリング・ヴィズィッジ
Terra	テラズ・ガーディアン
Syrian	トライアッズ・フォウリイッジ
Jalal's Mane	ジャラルズ・メイン
Malignant	マライナント・スカル
Apothecary's Tote	アパサカリーズ・トウト
Apocrypha	アポクリファ
Foci of Visjerei	フォーサイ・オヴ・ザ・ビジェレイ
Homunculus	ホムンクルス
Aurora's Guard	オーロラズ・ガード
Crest of Morn	クレスト・オヴ・モーン
Herald of Zakarum	ヘラルド・オヴ・ザカラム
Akarat's Protector	アカラッツ・プロテクター
Ancient Eye	エインシャント・アイ
Globe of Visjerei	グローブ・オヴ・ザ・ビジェレイ
The Oculus	ジ・オキュラス
Phoenix Egg	フェニックス・エッグ
Xenos	ジーノズ
Nagas	ナーガズ
Wyvern's Head	ワイヴァーンズ・ヘッド
Sightless Veil	サイトレス・ヴェイル
ChampionFormatX	%0 %1
EskillKickSing	回のキック
EskillKickPlur	回のキック
EskillPetLife	ペットのライフ：
EskillWolfDef	狼の防御値：
EskillPassiveFeral	狼と熊にパッシヴ・ボーナス
Eskillperhit12	（命中１回ごとに）
Eskillincasehit	（命中の場合）
Eskillincasemastery	クリティカル確率：%d％
Eskillincaseraven	レイヴン(鴉)１羽あたりのマナ消費量：
ob5	ジャレッズ・ストーン
pad	クラスト・シールド
axf	ハチェット・ハンズ
Eskillkickdamage	キック・ダメージ：
ModStre10k	キック・ダメージ：
ModStre10L	％の詠唱成功率
Class Specific	クラス専用
fana	凍てついたアーニャ
qsta5q14	ラーザック(Larzuk)が好きなアイテムにソケットを作ってくれる
qstsa5q42a	ヴォートの回廊(Halls of Vaught)にてニーラサック(Nihlathak)を捜せ
qstsa5q31a	アーニャ(Anya)を救出せよ
qstsa5q21a	囚われた戦士を解放し、街まで護送せよ
qstsa5q43a	アーニャ(Anya)がアイテムに名前を刻んでくれる
qstsa5q62a	バール(Baal)がワールドストーン(Worldstone)を汚染する前に、安置室(Chamber)で討ち取れ。
qstsa5q61a	破壊の玉座(Throne of Destruction)にてバールを捜し出せ
x	ゲームに入れません。一度、難易度「Nightmare」でバールを倒さなければ、「Hell」のゲームはプレイできません。
x	ゲームに入れません。バールを倒さなければ、難易度「Nightmare」のゲームはプレイできません。
x	新規キャラクター作成
x	
act1X	シスターの悲嘆
act2X	砂漠の旅
act3X	メフィストの密林
act4X	地獄へ
strepilogueX	恐怖の終焉
act5X	バール探索
strlastcinematic	破壊の終焉
CfgSay7	「退却！」と言う
0sc	知識の巻物
tr2	右クリックで詠唱\n耐性の巻物
of Lightning Strike	（ライトニング・ストライク）
of Plague Jab	（プラーグ・ジャブ）
of Charged Strike	（チャージド・ストライク）
of Impaling Strike	（インペイリング・ストライク）
of Poison Jab	（ポイズン・ジャブ）
of Power Strike	（パワー・ストライク）
of the Colossus	（ガルガンチュアン）
of the Kraken	（セントール）
Tal Rasha's Wrappings	タル・ラシャズ・ラッピングズ
Tal Rasha's Fire-Spun Cloth	タル・ラシャズ・ファイン＝スパン・クロス
Tal Rasha's Adjudication	タル・ラシャズ・アジュディケイション
Tal Rasha's Howling Wind	タル・ラシャズ・ガーディアンシップ
Tal Rasha's Lidless Eye	タル・ラシャズ・リッドレス・アイ
Tal Rasha's Horadric Crest	タル・ラシャズ・ホラドリック・クレスト
Hwanin's Seal	フワニンズ・ブレッシング
Heaven's Brethren	ヘヴンズ・ブリザリン
Dangoon's Teaching	ダングーンズ・ティーチング
Ondal's Almighty	オンダルズ・オルマイティ
Heaven's Taebaek	ティービークス・グローリー
Haemosu's Adament	ヒーモスズ・アダマント
Lycander's Flank	ライサンダーズ・フランク
Constricting Ring	コンストリクティング・リング
Ginther's Rift	ジンザーズ・リフト
Naj's Ancient Set	ナジュズ・エィンシェント・ヴェスティッジ
Naj's Light Plate	ナジュズ・ライト・プレート
Naj's Circlet	ナジュズ・サークレット
Sander's Superstition	マコーリーズ・スーパースティション
Sander's Taboo	マコーリーズ・タブー
Sander's Basis	マコーリーズ・ベイシス
Sander's Derby	マコーリーズ・プレッジ
Sander's Court Jester	マコーリーズ・フォリー
Ghost Liberator	ゴースト・リベレイター
Wilhelm's Pride	ヴィルヘルムズ・プライド
Immortal King's Stone Crusher	イモータル・キングズ・ストーン・クラッシャー
Immortal King's Pillar	イモータル・キングズ・ピラー
Immortal King's Forge	イモータル・キングズ・フォージ
Immortal King's Detail	イモータル・キングズ・ディティル
Immortal King's Soul Cage 	イモータル・キングズ・ソウル・ケイジ
Immortal King's Will	イモータル・キングズ・ウィル
Immortal King	イモータル・キング
Aldur's Gauntlet	オルダーズ・ライム
Ancient Statue 3	コーリック・ザ・プロテクター
Ancient Statue 2	マドウク・ザ・ガーディアン
Ancient Statue 1	タリック・ザ・ディフェンダー
Baal Subject 1	絶滅者コレンツォ
Baal Subject 2	呪われしアクメル
Baal Subject 3	鮮血のバータック
Baal Subject 4	神に背きしヴェンター
Baal Subject 5	拷問者リスター
Baal Subject 6	ザ・ブッチャー
Baal Subject 6a	ザ・ベイカー
Baal Subject 6b	ザ・キャンドルスティック・メイカー
Baal Crab Clone	バール
Baal Crab to Stairs	バール
BaalColdMage	デス・メイジ
Baal Subject Mummy	アンラヴェラー
Baal Tentacle	フェスタリング・アペンデイジズ
Baals Minion	ミニオン・オヴ・ディストラクション
Hell1	アバドン
Hell2	アケローンの穴
Hell3	冥界の穴
To Hell1	アバドンへ
To Hell2	アケローンの穴へ
To Hell3	冥界の穴へ
Lord of Destruction	
x	ファイルにアクセスできないため、キャラクターを変換できません
EskillPerBlade	（ブレード１本あたり）
ExInsertSockets	ソケットアイテムに挿入可能
McAuley's Superstition	サンダーズ・スーパースティション
McAuley's Taboo	サンダーズ・タブー
McAuley's Riprap	サンダーズ・リップラップ
McAuley's Paragon	サンダーズ・パラゴン
McAuley's Folly	サンダーズ・フォリー
x	Expansion Disc
qstsa5q62b	バールの部下たちを倒せ
x	(c) Copyright 2001 Blizzard Entertainment
of the Plague	(疫病)
Go South	地獄に戻る
ItemExpansiveChancX	%d%%の確率で、攻撃時にLv %d %s投射
ItemExpansiveChanc1	%d%%の確率で、命中時にLv %d %s投射
ItemExpansiveChanc2	%d%%の確率で、攻撃を受けた際にLv%d %s投射
ItemExpcharmdesc	所持品に入れておけばボーナスがつく
StrMercEx12	防御の
StrMercEx14	攻撃の
StrMercEx15	戦闘の
Eskillelementaldmg	エレメンタル・チャージアップ・ダメージ：
Playersubtitles29	退却！
Playersubtitles30	逃げろ！
LeaveCampDru	さて、始めるか
LeaveCampAss	気づかれる前に皆殺しよ
EnterDOEAss	暗いわね。ちょうどいいわ
EnterDOEDru	ここが悪の巣か
EnterBurialAss	これは誰のしわざ？
EnterBurialDru	屍を... 妙だな
EnterMonasteryAss	ひどい腐臭だわ... 
EnterMonasteryDru	悪の気があふれている
EnterForgottenTAss	もう思い出したくもない場所ね
EnterForgottenTDru	この臭いでは、無人になるのも当然だな
EnterJailAss	かかっておいで、魔物ども！
EnterJailDru	鉄格子などで大自然の力は封じられん
EnterCatacombsAss	気に入らないわね、ここ
EnterCatacombsDru	魔力の気配が強いぞ
CompletingDOEAss	これでテストは終了ね
CompletingDOEDru	ふん、この程度で終わりか？
CompletingBurialAss	もう生き返ることもないわ
CompletingBurialDru	お前の命は終わったのだ
FindingInifusAss	この樹はどうして汚染を逃れたのかしら？
FindingInifusDru	この枯木には魔力が満ちている
FindingCairnAss	古代の力を秘めた列柱ね
FindingCairnDru	故郷なら、こういう石はよくあるがな
FindingTristramAss	ディアブロの最初の犠牲ね
FindingTristramDru	廃墟か。すべての街はいずれこうなる
RescueCainAss	ケイン、ローグ族のキャンプへ！
RescueCainDru	デッカード・ケイン、すぐに発て！
HoradricMalusAss	マリュスだわ。これをチャルシに渡すのね
HoradricMalusDru	これでチャルシも喜ぶだろう
CompletingForgottenTPal	すごい宝の山ね。やっぱり臭いけど
CompletingForgottenTPal	こんな塔にも取り柄はあるものだな
CompletingAndarielAss	あなたには地獄がお似合いよ！
CompletingAndarielDru	お前の時代は終わったのさ
EnteringRadamentAss	どうして魔物はこんな汚い場所が好きなのよ？
EnteringRadamentDru	光を浴びろ。嫌なら、闇で朽ちるんだな
CompletingRadamentAss	アトマ、仇は取ったわよ
CompletingRadamentDru	ラダメント、土に帰れ
BeginTaintedSunAss	日蝕？　不吉だわ
BeginTaintedSunDru	妙だな、日蝕の予定はないはずだが
EnteringClawViperAss	暗黒の底で、暗黒の魔術ね
EnteringClawViperDru	蛇か... 蛇は好かんのだ
CompletingTaintedSunAss	ああ、思ったよりマシだった
CompletingTaintedSunDru	かくて世界は再び陽を浴びる、か
EnteringArcaneAss	秘密の聖域... ホラゾンの執念の産物ね
EnteringArcaneDru	ここは... 自然の摂理に逆らった場所だ
FindingSummonerAss	暗黒の術に心を蝕まれたのね
FindingSummonerDru	こんな場所に住めば、誰でもおかしくなる
CompletingSummonerAss	ホラゾンの偽者は倒したわよ
CompletingSummonerDru	やれやれ、やっとまともな場所に帰れる
FindingdecoyTombAss	ホラドリムの刻印があるわね
FindingdecoyTombDru	ホラドリムの刻印か。意味ありげだな
FindingTrueTombAss	タル・ラシャはきっとここね
FindingTrueTombDru	ここがタル・ラシャの墓か
CompletingTombAss	魔王め、地獄の果てまで追ってやる！
CompletingTombDru	ディアブロ... 必ず見つけるぞ！
FindingLamEsenAss	黒き書... 暗黒の知識にはお似合いね
FindingLamEsenDru	古代の書物か。役に立ちそうだ
CompletingLamEsenAss	本の値打ちは表紙ではわからない、か
CompletingLamEsenAss	それにしても、変な本が好きなのね
CompletingLamEsenDru	よく読んで研究してもらわんとな
FindingBeneathCityAss	忘れられた塔も臭かったけど、ここには負けるわ
FindingBeneathCityDru	ラット・ゴーレインの下水よりひどいな
FindingDrainLeverAss	このレバーを引くみたいね
FindingDrainLeverDru	これが排水レバーか
CompletingBeneathCityAss	宝物の掃除なら、楽なものだわ
CompletingBeneathCityDru	汚物の山から、財宝が出たか
CompletingBladeAss	素敵な短剣ね！　しばらく借りられないかしら？
CompletingBladeDru	オーマスなら、この変わった剣のことをよく知っていそうだ
FindingJadeFigAss	翡翠の像ねえ。何に使えるかしら？
FindingJadeFigDru	翡翠か... 売れば値打ちは出そうだが
FindingTempleAss	嫌な場所だわ
FindingTempleDru	ここは悪の巣だ
CompletingTempleAss	これで暗黒の魔力も消えるわ
CompletingTempleDru	ようやく、少しは希望が持てそうだ
FindingGuardianTowerAss	メフィスト、覚悟しなさい
FindingGuardianTowerDru	何だ、この気持ちは？... 憎悪か？
CompletingGuardianTowerAss	憎悪の王もかたなしね
CompletingGuardianTowerAss	憎悪とは魂を蝕む害毒だな
FreezingIzualAma	さようなら、イズアル
FreezingIzualAss	せいぜい罪を償うのね
FreezingIzualDru	同情はせん。当然の報いだ
KillingdDiabloSor	地獄の恐怖もこれまでよ！
KillingdDiabloBar	ディアブロ、永遠の責め苦を楽しむがいい！
KillingdDiabloNec	さらばだ、魔王どの
KillingdDiabloPal	これで魔王の支配も終わりを告げよう！
KillingdDiabloAms	恐怖の時代は終わったね
KillingdDiabloAss	勇者の過ちをやっと正せた... 
KillingdDiabloDru	かくて恐怖はついえたり、か
LeavingTownAct5Sor	私の術で、包囲を破ってみせる！
LeavingTownAct5Bar	さあ、故郷の大掃除だ！
LeavingTownAct5Nec	こんな包囲軍で、私を止められるものか
LeavingTownAct5Pal	バールめ、覚悟せよ！
LeavingTownAct5Ams	すぐに包囲を解かせてみせる！
LeavingTownAct5Ass	バール、暴虐の報いは死よ
LeavingTownAct5Dru	バール、首を洗って待っていろ！
CompletingStopSiegeSor	これでハロガスは安心だわ
CompletingStopSiegeBar	これで包囲は破った
CompletingStopSiegeNec	ふん、手間を取らせやがって
CompletingStopSiegePal	我、ハロガスを防衛せり！
CompletingStopSiegeAms	おやおや、これで終わり？
CompletingStopSiegeAss	シェンク、あなたの任務は終わりよ
CompletingStopSiegeDru	これで投石機はもう使えまい
RescueQual-KehkAct5Sor	こっちへ！
RescueQual-KehkAct5Bar	こっちへ！
RescueQual-KehkAct5Nec	こっちへ！
RescueQual-KehkAct5Pal	こっちへ！
RescueQual-KehkAct5Ams	こっちへ！
RescueQual-KehkAct5Ass	こっちへ！
RescueQual-KehkAct5Dru	こっちへ！
EnteringNihlathakAct5Sor	これは... トラップ？
EnteringNihlathakAct5Bar	腰抜けの隠れ家だな
EnteringNihlathakAct5Nec	なつかしい死の匂いだ
EnteringNihlathakAct5Pal	これは... 何という場所だ！
EnteringNihlathakAct5Ams	ニーラサックの住みかだね
EnteringNihlathakAct5Ass	やっぱり、ひどい所だわ
EnteringNihlathakAct5Dru	ニーラサック、逃がさんぞ
CompletingNihlathakAct5Sor	そんな魔力で、勝てると思った？
CompletingNihlathakAct5Bar	裏切り者にはお似合いの最期だ
CompletingNihlathakAct5Nec	弱さとは哀れなものだな
CompletingNihlathakAct5Pal	ニーラサック、なにゆえこのような事を？
CompletingNihlathakAct5Ams	バールとつるむとは、血迷ったね
CompletingNihlathakAct5Ass	堕落した魔道師はみんな同じ... 力に目がくらんだのね
CompletingNihlathakAct5Dru	裏切り者め、いい気味だ
EnteringTopMountAct5Sor	これが伝説の、古き民の土地？
EnteringTopMountAct5Bar	アリート山の守り手たちの地か
EnteringTopMountAct5Nec	ここが古き民の住まい... 
EnteringTopMountAct5Pal	ここがバーバリアンの聖地... 
EnteringTopMountAct5Ams	これが伝説の、古き民の土地？
EnteringTopMountAct5Ass	私の腕を見せてあげる
EnteringTopMountAct5Dru	ついに、アリートの頂に来たか
EnteringWorldstoneAct5Sor	感じるわ、ワールドストーンの力を
EnteringWorldstoneAct5Bar	古き民の広場か... すごいものだ
EnteringWorldstoneAct5Nec	古き民は、これを守っているわけか
EnteringWorldstoneAct5Pal	これが光輝の秘宝、ワールドストーン！
EnteringWorldstoneAct5Ams	ワールドストーンだね！
EnteringWorldstoneAct5Ass	ワールドストーン、物凄い力だわ！
EnteringWorldstoneAct5Dru	伝説のワールドストーン、自然界の護りだ
CompletingDefeatBaalAct5Sor	これで三魔王はすべて滅びたわ
CompletingDefeatBaalAct5Bar	これで魔王は残らず滅んだ 
CompletingDefeatBaalAct5Nec	バール、私を甘く見たな
CompletingDefeatBaalAct5Pal	魔神め、二度と地上に来させぬ！
CompletingDefeatBaalAct5Ams	これで役目は終わったわ
CompletingDefeatBaalAct5Ass	悪の兄弟もこれでおしまいね
CompletingDefeatBaalAct5Dru	バール、虚無の地で兄弟に会うんだな
Skillname222	レイヴン
Skillsd222	レイヴン(鴉)を召喚
Skillld222	敵の眼をえぐらせる\nレイヴン(鴉)を召喚し、
Skillan222	レイヴン
Skillname223	ポイズン・クリーパー
Skillsd223	有毒植物を召喚
Skillld223	触れた敵を汚染させる\n有毒植物を召喚し
Skillan223	Ｐ・クリーパー
Skillname223	ウィアウルフ
Skillsd223	ウィアウルフ(人狼)に変身
Skillld223	ウィアウルフ(人狼)に変身
Skillan223	ウィアウルフ
Skillname225	ライカントロピー
Skillsd225	パッシヴ - 変身能力が上達
Skillld225	持続時間とライフが上昇\nパッシヴ - ウィアウルフ、ウィアベア形態の
Skillan225	ライカントロピー
Skillname226	ファイアストーム
Skillsd226	炎の嵐を起こす
Skillld226	荒れ狂う炎の嵐を敵にたたきつける
Skillan226	ファイアストーム
Skillname227	オーク・セイジ
Skillsd227	オークの木の精霊（スピリット）を召喚
Skillld227	自分とパーティのライフを上昇させる\n神木の精霊(スピリット・ペット)を召喚し
Skillan227	オーク・セイジ
Skillname228	サモン・スピリット・ウルフ
Skillsd228	狼を召喚
Skillld228	味方として戦わせる\nテレポート能力を持った狼を召喚し
Skillan228	サモン・Ｓウルフ
Skillname229	ウィアベア
Skillsd229	ウィアベア(熊男)に変身
Skillld229	ウィアベア(熊男)に変身
Skillan229	ウィアベア
Skillname230	モルテン・ボールダー
Skillsd230	焼けつく石を発射
Skillld230	敵を跳ね飛ばす\n燃える溶岩の塊を発射し
Skillan230	Ｍ・ボールダー
Skillname231	アークティック・ブラスト
Skillsd231	凍てつく極地の風
Skillld231	敵に凍傷を負わせる\n超低温の風を吹き付け
Skillan231	Ａ・ブラスト
Skillname232	キャリオン・ヴァイン
Skillsd232	死体を食べる植物を召喚
Skillld232	術者にライフを送る\n召喚した植物が敵の死体を食べ
Skillan232	Ｃ・ヴァイン
Skillname233	フェラル・レイジ
Skillsd233	ライフを盗む攻撃 - ウィアウルフ形態時
Skillld233	吸収量が上昇\n攻撃が連続して成功すると\n野性の怒りに燃えて敵のライフを盗む\nウィアウルフ形態時、
Skillan233	フェラル・レイジ
Skillname234	モール
Skillsd234	敵を粉砕する - ウィアベア形態時
Skillld234	追加ダメージが上昇\n攻撃が連続して成功すると\n激しい打撃で敵を粉砕\nウィアベア形態時、
Skillan234	モール
Skillname235	フィシュア
Skillsd235	地割れを起こし敵を焼く
Skillld235	敵を焼き尽くす\n溶岩の地割れを開いて
Skillan235	フィシュア
Skillname236	サイクロン・アーマー
Skillsd236	自然や魔法の攻撃を防ぐ
Skillld236	ダメージを防ぐ\n火炎、冷気、稲妻の
Skillan236	サイクロン・Ａ
Skillname237	ハート・オヴ・ウルヴァリン
Skillsd237	獰猛な野獣の精霊を召喚
Skillld237	与えるダメージを上昇させる\n味方パーティの攻撃値と\n野獣の精霊(スピリット・ペット)を召喚して
Skillan237	H・ウルヴァリン
Skillname238	サモン・ダイア・ウルフ
Skillsd238	荒れ狂う狼を召喚
Skillld238	この狼は敵の死体を食べて強くなる\n荒れ狂う狼を召喚
Skillan238	サモン・Ｄウルフ
Skillname239	レイビーズ
Skillsd239	敵を咬んで、病気にする - ウィアウルフ形態時
Skillld239	他の敵にも蔓延させる\n敵を咬んで疫病に感染させ\nウィアウルフ形態時、
Skillan239	レイビーズ
Skillname240	ファイア・クローズ
Skillsd240	炎を帯びた粉砕攻撃
Skillld240	敵を粉砕する\n炎を帯びた爪の攻撃で\nウィアウルフまたはウィアベア形態時、
Skillan240	ファイアクローズ
Skillname241	ツイスター
Skillsd241	小さな旋風を発生させる
Skillld241	敵に切り込む道をつける\n小さな旋風を放ち
Skillan241	ツイスター
Skillname242	ソーラー・クリーパー
Skillsd242	死体を食べる植物を召喚
Skillld242	術者にマナを送る\n召喚した植物が敵の死体を食べ
Skillan242	Ｓ・クリーパー
Skillname243	ハンガー
Skillsd243	敵を咬んでライフとマナを盗む
Skillld243	ライフとマナを奪う\n敵を咬んで\nウィアウルフまたはウィアベア形態時、
Skillan243	ハンガー
Skillname244	ショック・ウェイヴ
Skillsd244	衝撃波を放つ - ウィアベア形態時
Skillld244	付近の敵をスタンさせる\n地面を踏んで衝撃波を放ち\nウィアベア形態時、
Skillan244	ショックウェイヴ
Skillname245	ヴォルケイノ
Skillsd245	火山を作る
Skillld245	敵の軍勢を焼き尽くす\n凄まじい火山を召喚し
Skillan245	ヴォルケイノ
Skillname246	トーネイド
Skillsd246	竜巻を作り出す
Skillld246	敵を吹き飛ばす\n石つぶてを巻き込んだ竜巻で
Skillan246	トーネイド
Skillname247	スピリット・オブ・バーブズ
Skillsd247	ダメージを返す棘の精霊
Skillld247	敵に返させる\n味方パーティが受けたダメージを\n棘の精霊（スピリット・ペット）を召喚し
Skillan247	スピリットバーブ
Skillname248	サモン・グリズリー
Skillsd248	グリズリー(ハイイログマ)を召喚
Skillld248	獰猛なグリズリー(ハイイログマ)を召喚
Skillan248	サモングリズリー
Skillname249	フューリー
Skillsd249	複数回攻撃 - ウィアウルフ形態時
Skillld249	同じ敵を複数回でも攻撃可能\n複数の敵にでも、\nウィアウルフ形態時、複数回攻撃
Skillan249	フューリー
Skillname250	アーマゲドン
Skillsd250	敵の頭上に炎の雨を降らせる
Skillld250	付近の敵を焼き尽くす\n炎の雨を降らせて
Skillan250	アーマゲドン
Skillname251	ハリケーン
Skillsd251	吹きすさぶ嵐を呼ぶ
Skillld251	敵全体に大打撃を与える\n石つぶてを巻き込んだ嵐を呼び、
Skillan251	ハリケーン
Skillname252	ファイア・ブラスト
Skillsd252	火炎弾を投げる
Skillld252	火炎弾を投げて敵を粉砕する
Skillan252	ファイア・ブラスト
Skillname253	クロー・マスタリー
Skillsd253	パッシヴ - クロー級武器の能力が上昇
Skillld253	スキルが上達\nパッシヴ - クロー級武器使用時の
Skillan253	クロー・マスタリー
Skillname254	サイキック・ハンマー
Skillsd254	精神衝撃波で敵を打ちのめす
Skillld254	敵を打ちのめし跳ね飛ばす\n精神衝撃波を放ち\n意志の力を使って
Skillan254	サイキック・Ｈ
Skillname255	タイガー・ストライク
Skillsd255	フィニッシュ攻撃のダメージが上昇\n\nチャージアップ・スキル
Skillld255	ドラゴン系か通常攻撃でフィニッシュすること\nチャージを使うには、\nフィニッシュ攻撃に追加ダメージ\n攻撃が連続して命中すると\n\nチャージアップ・スキル
Skillan255	タイガー・Ｓ
Skillname256	ドラゴン・タロン
Skillsd256	敵にキックを放つ\n\nフィニッシュ攻撃
Skillld256	キックにはチャージボーナス適用\n敵にキックを放ち跳ね飛ばす\n\nフィニッシュ攻撃
Skillan256	ドラゴン・タロン
Skillname257	ショック・ウェブ
Skillsd257	稲妻の網を投げる
Skillld257	敵を感電させる\n稲妻の網を投げて
Skillan257	ショック・ウェブ
Skillname258	ブレイド・センチネル
Skillsd258	回転する刃を設置
Skillld258	回転する刃を、目標点と自分の間で巡回させる
Skillan258	ブレイド・Ｓ
Skillname259	バースト・オヴ・スピード
Skillsd259	攻撃と移動の速度が上昇
Skillld259	しばらくの間だけ上昇する\n攻撃と移動の速度が
Skillan259	Ｂ・Ｏ・スピード
Skillname260	フィスツ・オヴ・ファイア
Skillsd260	フィニッシュ攻撃に火炎ダメージを追加\n\nチャージアップ・スキル
Skillld260	ドラゴン系か通常攻撃でフィニッシュすること\nチャージを使うには、\nクロー級武器の場合のみ有効\nフィニッシュ攻撃に火炎ダメージを追加\n攻撃が連続して命中すると\n\nチャージアップ・スキル
Skillan260	ファイアフィスツ
Skillname261	ドラゴン・クロー
Skillsd261	両手のクロー攻撃\n\nフィニッシュ攻撃
Skillld261	チャージアップ・ボーナスが適用される\n両方のクロー級武器に\n両手のクロー級武器で敵を切り刻む\n\nフィニッシュ攻撃
Skillan261	ドラゴン・クロー
Skillname262	チャージド・ボルト・セントリー
Skillsd262	チャージド・ボルトを放つトラップ
Skillld262	チャージド・ボルトを放つトラップ\n近くを通った敵に
Skillan262	ＣＢセントリー
Skillname263	ウェイク・オヴ・ファイア
Skillsd263	炎の航跡を残すトラップ
Skillld263	炎の航跡を残すトラップ
Skillan263	ウェイク・オヴＦ
Skillname264	ウェポン・ブロック
Skillsd264	ブロックの可能性が生まれる\nパッシヴ - 二つのクロー級武器を装備した際、
Skillld264	敵の攻撃をブロックできる可能性がある\nパッシヴ - 二つのクロー級武器を装備している時、
Skillan264	Ｗ・ブロック
Skillname265	クローク・オヴ・シャドウズ
Skillsd265	敵の視力を奪う
Skillld265	一定期間、防御値を下げる\n敵を影で覆って視力を奪い、
Skillan265	Ｃ・シャドウズ
Skillname266	コブラ・ストライク
Skillsd266	フィニッシュ攻撃でライフとマナを盗む\n\nチャージアップ・スキル
Skillld266	ドラゴン系か通常攻撃でフィニッシュすること\nチャージを使うには、\nフィニッシュ攻撃でライフとマナを盗む\n攻撃が連続して命中すると\n\nチャージアップ・スキル
Skillan266	コブラストライク
Skillname267	ブレイド・フューリー
Skillsd267	回転する刃を投げる
Skillld267	敵を切り刻む\n回転する刃を投げて
Skillan267	Ｂ・フューリー
Skillname268	フェイド
Skillsd268	一時的に全耐性が上昇
Skillld268	呪いへの抵抗力が上昇\n一時的にすべての耐性と
Skillan268	フェイド
Skillname269	シャドウ・ウォリアー
Skillsd269	自分の影を召喚
Skillld269	影を召喚して味方につける\n自分の動きをそっくり真似る
Skillan269	Ｓ・ウォリアー
Skillname270	クローズ・オヴ・サンダー
Skillsd270	フィニッシュ攻撃に稲妻ダメージを追加\n\nチャージアップ・スキル
Skillld270	ドラゴン系か通常攻撃でフィニッシュすること\nチャージを使うには、\nクロー級武器の場合のみ有効\nフィニッシュ攻撃に稲妻ダメージを追加\n攻撃が連続して命中すると\n\nチャージアップ・スキル
Skillan270	サンダークローズ
Skillname271	ドラゴン・テイル
Skillsd271	爆発するキックを放つ\n\nフィニッシュ攻撃
Skillld271	キックにはチャージボーナスが適用される\n爆発するキックで敵を跳ね飛ばす\n\nフィニッシュ攻撃
Skillan271	ドラゴン・テイル
Skillname272	ライトニング・セントリー
Skillsd272	稲妻を放つトラップ
Skillld272	近づく敵を感電させるトラップ\n稲妻を放射して
Skillan272	Ｌ・セントリー
Skillname273	ウェイク・オヴ・インフェルノ
Skillsd273	火炎放射のトラップ
Skillld273	近づく敵に火炎放射を浴びせるトラップ
Skillan273	Ｗ・インフェルノ
Skillname274	マインド・ブラスト
Skillsd274	精神波で敵を服従させる
Skillld274	朦朧とした敵を服従させる\n敵の集団をスタンさせ\n精神力で衝撃波を放って
Skillan274	マインドブラスト
Skillname275	ブレイド・オヴ・アイス
Skillsd275	フィニッシュ攻撃に冷気ダメージを追加\n\nチャージアップ・スキル
Skillld275	ドラゴン系か通常攻撃でフィニッシュすること\nチャージを使うには、\nクロー級武器の場合のみ有効\nフィニッシュ攻撃に冷気ダメージを追加\n攻撃が連続して命中すると\n\nチャージアップ・スキル
Skillan275	ブレイド・アイス
Skillname276	ドラゴン・フライト
Skillsd276	テレポートしてキックを放つ\n\nフィニッシュ攻撃
Skillld276	キックにはチャージボーナスが適用される\n鋭いキックを放つ\n敵の前までテレポートして\n\nフィニッシュ攻撃
Skillan276	ドラゴンフライト
Skillname277	デス・セントリー
Skillsd277	付近の死体を爆発させるトラップ
Skillld277	付近の死体を爆発させる機能を持つトラップ\n敵に稲妻を放つ機能と
Skillan277	デス・セントリー
Skillname278	ブレイド・シールド
Skillsd278	回転する刃で防御
Skillld278	回転する刃で切り裂くシールド\n接近してきた敵を
Skillan278	ブレイドシールド
Skillname279	ヴェノム
Skillsd279	武器に毒を塗る
Skillld279	武器に毒物ダメージを追加
Skillan279	ヴェノム
Skillname280	シャドウ・マスター
Skillsd280	自分の影を味方につける
Skillld280	強力な味方になる\n自分の影を召喚すると
Skillan280	Ｓ・マスター
Skillname281	フェニックス・ストライク
Skillsd281	フィニッシュ攻撃にエレメンタル・ノヴァを追加\n\nチャージアップ・スキル
Skillld281	ドラゴン系か通常攻撃でフィニッシュすること\nチャージを使うには、\nフィニッシュ攻撃にエレメンタル・ノヴァを追加\n\nチャージアップ・スキル
Skillan281	フェニックス・Ｓ
ESkillHawk	レイヴン(鴉)の数：
ESkillSpikes	スパイク数：
ESkillStars	数量：
ESkillWolf	狼：
ESkillWolves	狼の数：
ESkillShoots	攻撃回数：
ESkillTimes	回
ESkillSpikes2	本のスパイク
ESkillPerKick	(１回のキックにつき)
EskillLifeSteal	奪うライフ：
Eskillchancetostun	スタン確率：
Eskillchancetoafflict	感染確率：
Eskillpowerup1	チャージ１：
Eskillpowerup2	チャージ２：
Eskillpowerup3	チャージ３：
Eskillpowerupadd	追加：
Eskillsinishup	フィニッシュ攻撃ボーナス
Eskillpudlife	％のライフを奪う
Eskillpudmana	％のライフとマナを奪う
Eskillpudburning	火炎ダメージ
Eskillpuddgmper	％のダメージ
Eskilllowerresis	耐性低下
Eskilltomeleeattacks	(近接攻撃のみ)
EskillManaSteal	奪うマナ：
Eskillferalpets	動物の数：
Eskillpercentatt	％の攻撃
Eskillpercentlif	％のライフ
Eskillpercentdmg	％のダメージ
Eskillfinishmove	フィニッシュ攻撃 - 
Eskillmanarecov	マナ回復：
Eskillphoenix1	メテオダメージ：
Eskillphoenix2	チェイン・ライトニング・ダメージ：
Eskillphoenix3	ケイオス・アイス・ボルト・ダメージ：
Eskillthunder1	稲妻ダメージ：
Eskillthunder2	ノヴァ・ダメージ：
Eskillthunder3	チャージド・ボルト・ダメージ：
Eskillfistsoffire1	火炎ダメージ：
Eskillfistsoffire2	火炎ダメージ範囲：
Eskillfistsoffire3	火炎持続時間：
Eskillbladesofice1	冷気ダメージ：
Eskillbladesofice2	冷気ダメージ範囲：
Eskillbladesofice3	凍結持続時間：
strUI5	レイヴン
strUI6	ウルフ
strUI7	ベアー
strUI8	ポイズン・クリーパー
strUI9	キャリオン・ヴァイン
strUI10	ソーラー・クリーパー
strUI11	スピリット・オブ・バーブズ
strUI12	ハート・オヴ・ウルヴァリン
strUI13	ヴァイン
strUI14	スピリット
UIFenirsui	ダイアウルフ
UiRescuedBarUI	ウォリアー
UiShadowUI	シャドウ
StrUI18	マスター
Spike Generator	スパイク・ジェネレイター
Charged Bolt Sentry	チャージド・ボルト・セントリー
Lightning Sentry	ライトニング・セントリー
Blade Creeper	ブレイド・センチネル
Invis Pet	ペット
Druid Hawk	レイヴン
Druid Wolf	ウルフ
Druid Totem	ドルイド・スピリット
Druid Fenris	ダイア・ウルフ
Druid Spirit Wolf	スピリット・ウルフ
Druid Bear	グリズリー
Druid Plague Poppy	プラーグ・ポピー
Druid Cycle of Life	サイクル・オヴ・ライフ
Vine Creature	ヴァイン・クリーチャー
Eagleexp	イーグル
Wolf	ウルフ
Bear	ベアー
Siege Door	シージ・ドア
Seige Tower	攻城塔
RotWalker	ロット・ウォーカー
ReanimatedHorde	リアニメイテッド・ホード
ProwlingDead	プラウリング・デッド
UnholyCorpse	アンホーリー・コープス
DefiledWarrior	ディファイルド・ウォリアー
Siege Beast	シージ・ビースト
CrushBiest	クラッシュ・ビースト
BloodBringer	ブラッド・ブリンガー
GoreBearer	ゴア・ベアラー
DeamonSteed	デモン・スティード
WailingSpirit	ウェイリング・スピリット
LifeSeeker	ライフ・シーカー
LifeStealer	ライフ・スティーラー
DeathlyVisage	デスリー・ヴィザージュ
BoundSpirit	バウンド・スピリット
BanishedSoul	バニッシュト・ソウル
Deathexp	デスリー・ヴィザージュ
Minionexp	エンスレイヴド
Slayerexp	スレイヤー
IceBoar	アイス・ボア
FireBoar	ファイア・ボア
HellSpawn	ヘル・スポーン
IceSpawn	アイス・スポーン
GreaterHellSpawn	グレーター・ヘル・スポーン
GreaterIceSpawn	グレーター・アイス・スポーン
FanaticMinion	ファナティック・エンスレイヴド
BerserkSlayer	バーサーカー・スレイヤー
ConsumedFireBoar	コンシュームド・ファイア・ボア
ConsumedIceBoar	コンシュームド・アイス・ボア
FrenziedHellSpawn	フレンジード・ヘル・スポーン
FrenziedIceSpawn	フレンジード・アイス・スポーン
InsaneHellSpawn	インセイン・ヘル・スポーン
InsaneIceSpawn	インセイン・アイス・スポーン
Succubusexp	サキュバス
VileTemptress	ヴァイル・テンプトレス
StygianHarlot	スティジアン・ハーロット
Hell Temptress	ヘル・テンプトレス
Blood Temptress	ブラッド・テンプトレス
Dominus	サイレン
VileWitch	ヴァイル・ウィッチ
StygianFury	スティジアン・フューリー
Blood Witch	ブラッド・ウィッチ
Hell Witch	ヘル・ウィッチ
OverSeer	オーヴァーシーアー
Lasher	ラッシャー
OverLord	オーヴァーロード
BloodBoss	ブラッド・ボス
HellWhip	ヘル・ウィップ
MinionSpawner	デモン・ポータル
MinionSlayerSpawner	デモン・ポータル
MinionIce/fireBoarSpawner	デモン・ポータル
Minionice/hellSpawnSpawner	デモン・ポータル
MinionGreaterIce/hellSpawnSpawner	デモン・ポータル
Imp1	デモン・インプ
Imp2	デモン・ラスカル
Imp3	デモン・グレムリン
Imp4	デモン・トリックスター
Imp5	デモン・スプライト
CatapultN	投石機
CatapultS	投石機
CatapultE	投石機
CatapultW	投石機
Frozen Horror1	フローズン・クリーパー
Frozen Horror2	フローズン・テラー
Frozen Horror3	フローズン・スカージ
Frozen Horror4	フローズン・ホラー
Frozen Horror5	フローズン・スコーチ
Blood Lord1	ムーン・ロード
Blood Lord2	ナイト・ロード
Blood Lord3	ブラッド・ロード
Blood Lord4	ヘル・ロード
Blood Lord5	デス・ロード
Catapult Spotter N	投石機
Catapult Spotter S	投石機
Catapult Spotter E	投石機
Catapult Spotter W	投石機
Catapult Spotter Siege	投石機
CatapultSiege	投石機
Barricade Wall Right	バリケード
Barricade Wall Left	バリケード
Barricade Door	バリケードでふさがれたドア
Barricade Tower	バリケードでふさがれた塔
Siege Boss	シェンク・ジ・オーヴァーシーアー
Evil hut	イーヴル・デモン・ハット
Death Mauler1	デス・モーラー
Death Mauler2	デス・ブローラー
Death Mauler3	デス・スラッシャー
Death Mauler4	デス・バーサーカー
Death Mauler5	デス・ブリガディア
SnowYeti1	スノー・ドリフター
SnowYeti2	アボミナブル
SnowYeti3	チルド・フロス
SnowYeti4	フローズン・アビス
Baal Throne	バール
Baal Crab	バール
Baal Taunt	バール
Putrid Defiler1	ピュートリッド・ディファイラー
Putrid Defiler2	レッチト・ディファイラー
Putrid Defiler3	フェティッド・ディファイラー
Putrid Defiler4	ランシッド・ディファイラー
Putrid Defiler5	ランク・ディファイラー
Pain Worm1	ペイン・ワーム
Pain Worm2	トーメント・ワーム
Pain Worm3	アゴニー・ワーム
Pain Worm4	メナス・ワーム
Pain Worm5	アンギッシュ・ワーム
WolfRider5	ウォープト・フォールン・ウルフライダー
WolfRider4	ダークワン・ウルフライダー
WolfRider3	デヴィルキン・ウルフライダー
WolfRider2	カーヴァー・ウルフライダー
WolfRider1	フォールン・ウルフライダー
Oak Sage	オーク・セイジ
Heart of Wolverine	ハート・オヴ・ウルヴァリン
Spirit of Barbs	スピリット・オヴ・バーブズ
Shadow Warrior	シャドウ・ウォリアー
Death Sentry	デス・セントリー
Inferno Sentry	インフェルノ・セントリー
Shadow Master	シャドウ・マスター
Wake of Destruction	ウェイク・オヴ・ファイア
Ghostly	ゴーストリー・
Fanatic	ファナティック・
Possessed	ポゼスト・
Berserk	バーサーカー・
Larzuk	ラーザック
Drehya	アーニャ
Malah	マラー
Nihlathak Town	ニーラサック
Qual-Kehk	クォル＝ケック
Act 5 Townguard	守備兵
Act 5 Combatant	戦士
Nihlathak	ニーラサック
POW	バーバリアンの捕虜
Moe	モー
Curly	カーリー
Larry	ラリー
Ancient Barbarian 3	コーリック
Ancient Barbarian 2	マドウク
Ancient Barbarian 1	タリク
Blaze Ripper	ブレイズ・リッパー
Magma Torquer	マグマ・トルカー
Sharp Tooth Sayer	シャープトゥース・スレイヤー
Vinvear Molech	ヴィンヴェイア・モレック
Anodized Elite	ヘルズ・ベル
Snapchip Shatter	スナップチップ・シャター
Pindleskin	ピンドルスキン
Threash Socket	スレッシュ・ソケット
Eyeback Unleashed	アイバック・ジ・アンリーシュト
Megaflow Rectifier	エルドリッチ・ザ・リクティファイアー
Dac Farren	ダック・ファレン
Bonesaw Breaker	ボーンソウ・ブレイカー
Axe Dweller	アックス・ドゥエラー
Frozenstein	フローズンシュタイン
strDruidOnly	(ドルイドのみ)
strAssassinOnly	(アサシンのみ)
strAmazonOnly	(アマゾンのみ)
strBarbarianOnly	(バーバリアンのみ)
StrSklTree26	召喚呪文
StrSklTree27	変身能力
StrSklTree28	
StrSklTree29	エレメンタル
StrSklTree30	トラップ
StrSklTree31	シャドウ・
StrSklTree32	ディシプリン
StrSklTree33	マーシャル
StrSklTree34	アーツ
x	自然の力を操り、野獣を召喚する戦闘魔道師。
x	格闘とトラップに熟達した暗殺者。
chestr	箱
barrel wilderness	樽
woodchestL	木箱
burialchestL	棺
burialchestR	棺
well	井戸
Waypoint	中継点(ウェイポイント)
ChestL	箱
ChestSL	箱
ChestSR	箱
woodchestR	木箱
chestR	箱
burningbodies	死体の山
burningpit	燃える穴
tribal flag	部族の旗
flag widlerness	旗
eflg	街の旗
chan	シャンデリア
jar	瓶
jar2	瓶
jar3	瓶
swingingheads	揺れる生首
pole	旗竿
animatedskullsandrocks	髑髏と岩
hellgate	地獄の門
gate	正門
banner1	のぼり
banner2	のぼり
mrpole	旗竿
pene	収納箱
debris	瓦礫
woodchest2R	木箱
woodchest2L	木箱
object1	秘密の隠し場所
magic shrine2	魔法のほこら
torch2	たいまつ
torch1	たいまつ
tomb3	墓所
tomb2	墓所
tomb1	墓所
ttor	たいまつ
icecave_torch2	たいまつ
icecave_torch1	たいまつ
clientsmoke	煙
deadbarbarian	バーバリアンの死体
deadbarbarian18	バーバリアンの屍
uncle f#%* comedy central(c)	モー
cagedwussie1	檻
icecaveshrine2	ほこら
icecavejar4	瓶
icecavejar3	瓶
icecavejar2	瓶
icecavejar1	瓶
evilurn	邪悪の壺
secret object	秘密の物体
Altar	祭壇
Ldeathpole	死の旗竿
deathpole	死の旗竿
explodingchest	箱
banner 2	のぼり
banner 1	のぼり
pileofskullsandrocks	髑髏と岩
animated skulland rockpile	髑髏と岩
jar1	瓶
etorch2	たいまつ
ettr	たいまつ
ecfra	炎
etorch1	たいまつ
healthshrine	健康のほこら
explodingbarrel	樽
flag wilderness	旗
object	秘密の隠し場所
Shrine2wilderness	ほこら
Shrine3wilderness	ほこら
pyox	炎の穴
ptox	たいまつの穴
Siege Control	攻城塔の制御装置
mrjar	秘密の隠し場所
object2	秘密の隠し場所
mrbox	箱
tomb3L	墓所
tomb2L	墓所
tomb1L	墓所
red light	赤い光
groundtombL	墓所
groundtomb	墓所
deadperson	屍
candles	蝋燭
sbub	灌木
ubub	灌木
deadperson2	屍
Prison Door	牢獄の扉
ancientsaltar	天界の祭壇
hiddenstash	秘密の隠し場所
eweaponrackL	武器ラック
eweaponrackR	武器ラック
earmorstandL	防具立て
earmorstandR	防具立て
qstsa5q1	ハロガス包囲
qsta5q11	鮮血の山麓(Bloody Foothills)にてシェンク・ジ・オーヴァーシーアー(Shenk the Overseer)を倒し、包囲を解かせよ。
qsta5q12	シェンク・ジ・オーヴァーシーアー(Shenk the Overseer)を討ち取れ。
qsta5q13	ラーザック(Larzuk)に会い、報酬を受け取れ。
qstsa5q2	アリート山の救出
qstsa5q21	極寒の高地(Frigid Highlands)の兵士を見つけよ。
qstsa5q22	極寒の高地(Frigid Highlands)にて、あと%d名の兵士を救出せよ。
qstsa5q23	クォル＝ケック(Qual-Kehk)に会い、報酬を受け取れ。
qstsa5q24	ソケットアイテムに、以下の順序でルーンをあてはめよ：
qstsa5q3	氷の牢獄
qstsa5q31	水晶の小径(Crystalline Passage)の地下、凍てついた河（Frozen River）の付近で、アーニャ(Anya)を捜せ。
qstsa5q32	マラーに話しかけよ
qstsa5q33	マラー(Malah)のポーションを使ってアーニャ(Anya)を溶かせ。
qstsa5q34	マラー(Malah)に会い、報酬を受け取れ。
qstsa5q35	アーニャ(Anya)と話せ。
qstsa5q4	ハロガスの裏切り
qstsa5q41	アーニャ(Anya)のポータル通ってニーラサックの寺院(Nihlathak's Temple)に行け。
qstsa5q42	ニーラサック(Nihlathak)を討ち取れ。
qstsa5q43	アリート山(Mount Arreat)を目指す前に、アーニャ(Anya)と話せ。
qstsa5q5	通過儀礼
qstsa5q51	古き民の道(Ancient's Way)を行き、アリート山頂(Arreat Summit)にて古き民(Ancients)に会え。
qstsa5q52	天界の祭壇（Altar of the Heavens）を起動し、古き民(Ancients)の話を聞け。
qstsa5q53	アリート山(Mount Arreat)を去ることなく、３人の古き民(Ancients)をすべて打ち負かせ。
qstsa5q6	破壊前夜
qstsa5q61	古き民(Ancients)の話を聞け。
qstsa5q62	バールを討ち取れ。
qstsa5q63	ティラエル(Tyreal)と話せ。
qstsa5q64	ティラエル(Tyreal)のポータルを通って金庫(Safety)に迎え。
Harrogath	ハロガス
Bloody Foothills	鮮血の山麓
Rigid Highlands	極寒の高地
Arreat Plateau	アリート台地
Crystalized Cavern Level 1	水晶の小径
Cellar of Pity	凍てついた河
Crystalized Cavern Level 2	氷河の街道
Echo Chamber	放浪者の洞窟
Tundra Wastelands	凍てついたツンドラ
Glacial Caves Level 1	古き民の道
Glacial Caves Level 2	氷の地下蔵
Rocky Summit	アリート山頂
Nihlathaks Temple	ニーラサックの寺院
Halls of Anguish	激痛の回廊
Halls of Death's Calling	苦悶の回廊
Halls of Tormented Insanity	業苦の回廊
Halls of Vaught	ヴォートの回廊
The Worldstone Keep Level 1	ワールドストーンの城塞　レベル1
The Worldstone Keep Level 2	ワールドストーンの城塞　レベル2
The Worldstone Keep Level 3	ワールドストーンの城塞　レベル3
The Worldstone Chamber	ワールドストーン安置室
Throne of Destruction	破壊の玉座
To Harrogath	ハロガスへ
To The Bloody Foothills	鮮血の山麓へ
To The Rigid Highlands	極寒の高地へ
To The Arreat Plateau	アリート台地へ
To The Crystalized Cavern Level 1	水晶の小径へ
To The Cellar of Pity	凍てついた河へ
To The Crystalized Cavern Level 2	氷河の街道へ
To The Echo Chamber	放浪者の洞窟へ
To The Tundra Wastelands	凍てついたツンドラへ
To The Glacier Caves Level 1	古き民の道へ
To The Glacier Caves Level 2	氷の地下蔵へ
To The Rocky Summit	アリート山頂へ
To Nihlathaks Temple	ニーラサックの寺院へ
To The Halls of Anguish	激痛の回廊へ
To The Halls of Death's Calling	苦悶の回廊へ
To The Halls of Tormented Insanity	業苦の回廊へ
To The Halls of Vaught	ヴォートの回廊へ
To The Worldstone Keep Level 1	ワールドストーンの城塞　レベル1へ
To The Worldstone Keep Level 2	ワールドストーンの城塞　レベル2へ
To The Worldstone Keep Level 3	ワールドストーンの城塞　レベル3へ
To The Worldstone Chamber	ワールドストーン安置室へ
To The Throne of Destruction	破壊の玉座へ
hireiconinfo1	肖像画にポーションをドロップすればヒーリング
hireiconinfo2	右クリックすると所持品を開く(%s)
hiredismiss	解雇
hiredismisshire	傭兵を解雇
hirerehire	再び雇う
hireresurrect	復活させる
hireresurrect2	%sを復活させる：%d
hirechat1	ありがとう
hirechat2	ありがとう
hirechat3	よかった
hirepraise1	あんたのためなら命を張れる
hirepraise2	役に立ってみせるよ
hiredanger1	危険だ
hiredanger2	怪物どもだ
hiredanger3	悪い予感がする
hiredanger4	気をつけろ！
hiredanger5	蜘蛛は嫌いなんだ
hiredanger6	わあ、蛇だ！
hirefeelstronger2	いい経験になった
hirehelp1	やられた！
hirehelp2	助けて！
hirehelp3	死んじまう！
hirehelp4	助けて！
hiregreets1	おはよう
hiregreets2	こんにちは
hiregreets3	こんばんは
hiregreets4	やあ
CfgSkill9	スキル 9
CfgSkill10	スキル 10
CfgSkill11	スキル 11
CfgSkill12	スキル 12
CfgSkill13	スキル 13
CfgSkill14	スキル 14
CfgSkill15	スキル 15
CfgSkill16	スキル 16
CfgToggleminimap	ミニマップの切り替え
Cfgswapweapons	ウェポン・スワッピング
Cfghireling	傭兵画面
MiniPanelHireinv	傭兵の所持品
MiniPanelHire	傭兵
x	
x	拡張版キャラクター
x	拡張版に変換
x	「ＯＫ」をクリックすると、『Diablo II』のキャラクターを拡張版で使えるよう変換します。
X	警告： 拡張版に変換したキャラクターで、オリジナルDiablo IIのゲームをプレイすることはできません。
X	
X	本当に続行しますか？
Go North	北へ行く
Travel To Harrogath	ハロガスに向かう
x	新規拡張版キャラクター
x	新規拡張版オープンキャラクター
x	新規拡張版レルムキャラクター
X	拡張版に変換
X	新規キャラクター作成
X	キャラクター消去
X	イシリアル (天界のアイテム。修理不能)
X	このアイテムは修理できない
Rename Instruct	名前を刻むアイテムを選択
Addsocketsui	ソケットを作る
Personalizeui	名前を刻む
Addsocketsui2	ソケットを作るアイテムを選択
MercX101	ヴァーダカ
MercX102	カーン
MercX103	クリスク
MercX104	ボース
MercX105	ブロム
MercX106	ウィグラフ
MercX107	フロスガー
MercX108	サイルド
MercX109	ヘルフデイン
MercX110	ヒオロガー
MercX111	ハルゴーント
MercX112	ハイジェラック
MercX113	イグセオウ
MercX114	ボーダン
MercX115	ウルフガー
MercX116	ヒルド
MercX117	ヒーソラフ
MercX118	ウェダー
MercX119	ヴィキアット
MercX120	アンファース
MercX121	ジークムント
MercX122	ヘレモンド
MercX123	ヘンゲスト
MercX124	フォルクウォルド
MercX125	フリシアン
MercX126	フナエフ
MercX127	ガスラフ
MercX128	オスラフ
MercX129	ユーメンラフ
MercX130	ガームンド
MercX131	フリーワル
MercX132	イードジルス
MercX133	オネラ
MercX134	ダミエン
MercX135	エルフォー
MercX136	ウェオスタン
MercX137	ウールフ
MercX138	ブルワイア
MercX139	リーフ
MercX140	マグナス
MercX141	クラトゥー
MercX142	ドルス
MercX143	ホク
MercX144	コード
MercX145	ウーサー
MercX146	イップ
MercX147	ウルッフ
MercX148	サール
MercX149	ケイリム
MercX150	ウルリック
MercX151	アラリック
MercX152	エセルレッド
MercX153	カーデン
MercX154	エルジフ
MercX155	トスティグ
MercX156	アルクイン
MercX157	イームンド
MercX158	ジークルート
MercX159	ゴルム
MercX160	ホリス
MercX161	ラグナー
MercX162	トーケル
MercX163	ウルフスタン
MercX164	アルバン
MercX165	バーロック
MercX166	ビル
MercX167	セオドリック
