White 	白い
Gray 	灰色の
Metallic 	メタリックの
Black 	黒い
Azure 	空色の
Cobalt 	コバルトの
Blue 	青い
Carmine 	カーマインの
Crimson 	深紅の
Red 	赤い
Beryl 	ベリルの
Viridian 	ビリジアンの
Green 	緑の
Yellow 	黄色い
Ocher 	黄土の
Tangeline 	赤橙の
Gold 	黄金の
Violet 	スミレ色の
Purple 	紫の
Orange 	オレンジの
Silver 	銀の
Harvest	ハーベスト
Providence	プロビデンス
Feather	フェザー
Misery	ミセリー
Impact	インパクト
Eternity	エタニティ